States/UTs,Crime Head,Year,Persons arrested during the year_Male,Persons arrested during the year_Female,Persons arrested during the year_Total
Andhra Pradesh,1 - Murder (Section 302 and 303 IPC),2014,68,5,73
Andhra Pradesh,2 - Infanticide (Section 315 IPC),2014,3,0,3
Andhra Pradesh,3 - Rape,2014,617,21,638
Andhra Pradesh,4 - Assault on women with intent to outrage her Modesty (Section 354 IPC),2014,281,4,285
Andhra Pradesh,4.1 - Sexual Harassment (Section 354A IPC),2014,69,0,69
Andhra Pradesh,4.2 - Assault on women with intent to Disrobe (Section 354B IPC),2014,18,0,18
Andhra Pradesh,4.3 - Voyeurism (Section 354C IPC),2014,6,0,6
Andhra Pradesh,4.4 - Stalking (Section 354D IPC),2014,113,4,117
Andhra Pradesh,4.5 - Others assault,2014,75,0,75
Andhra Pradesh,5 - Insult to the Modesty of Women (Girls Children) (Section 509 IPC),2014,127,0,127
Andhra Pradesh,"6 - Kidnapping & Abduction_Total (Section 363,364,364A, 366-369 IPC)",2014,675,9,684
Andhra Pradesh,6.1 - Kidnapping & Abduction (Section 363 IPC),2014,200,5,205
Andhra Pradesh,6.2 - Kidnaping & Abduction in order to Murder (Section 364 IPC),2014,0,0,0
Andhra Pradesh,6.3 - Kidnapping for Ransom (Section 364A IPC),2014,7,0,7
Andhra Pradesh,6.4 - Kidnapping & Abduction of Women to compel her for marriage (Section 366 IPC),2014,210,1,211
Andhra Pradesh,6.5 - Other Kidnapping,2014,258,3,261
Andhra Pradesh,7 - Foeticide (Section 315 and 316 IPC),2014,0,0,0
Andhra Pradesh,8 - Abetment of Suicide of child (Section 305 IPC),2014,4,1,5
Andhra Pradesh,9 - Exposure and Abandonment (Section 317 IPC),2014,24,0,24
Andhra Pradesh,10 - Procuration of minor girls (Section 366-A IPC),2014,34,0,34
Andhra Pradesh,11 - Importation of Girls from Foreign Country (Section 366-B IPC),2014,0,0,0
Andhra Pradesh,12 - Buying of minors for prostitution (Section 373 IPC),2014,0,0,0
Andhra Pradesh,13 - Selling of minors for prostitution (Section 372 IPC),2014,0,0,0
Andhra Pradesh,"14 - Prohibition of Child Marriage Act, 2006",2014,29,5,34
Andhra Pradesh,"15 - Transplantation of Human Organs Act, 1994",2014,0,0,0
Andhra Pradesh,"16 - Child Labour (Prohibition & Regulation) Act, 1986",2014,0,0,0
Andhra Pradesh,16.1 - Offences committed against Migrant,2014,0,0,0
Andhra Pradesh,16.1.1 - Offences committed against SC migrants,2014,0,0,0
Andhra Pradesh,16.1.2 - Offences committed against ST migrants,2014,0,0,0
Andhra Pradesh,16.1.3 - Offences committed against others migrants,2014,0,0,0
Andhra Pradesh,16.2 - Offences committed against Locals,2014,0,0,0
Andhra Pradesh,16.2.1 - Offences committed against Local SCs,2014,0,0,0
Andhra Pradesh,16.2.2 - Offences committed against Local STs,2014,0,0,0
Andhra Pradesh,16.2.3 - Offences committed against others locals,2014,0,0,0
Andhra Pradesh,"17 - Immoral Traffic (Prevention) Act, 1956",2014,19,4,23
Andhra Pradesh,17.1 - Under ITP Section 5,2014,3,0,3
Andhra Pradesh,17.2 - Under ITP Section 6,2014,0,0,0
Andhra Pradesh,17.3 - Under ITP Section 7,2014,0,0,0
Andhra Pradesh,17.4 - Under ITP Section 8,2014,0,0,0
Andhra Pradesh,17.5 - Other Section of ITP Act,2014,16,4,20
Andhra Pradesh,"18 - Juvenile Justice (Care and Protection of Children) Act, 2000",2014,2,1,3
Andhra Pradesh,"19 - Protection of Children from Sexual Offences Act, 2012",2014,111,2,113
Andhra Pradesh,19.1 - Under PCSO Act Section 4,2014,28,1,29
Andhra Pradesh,19.2 - Under PCSO Act Section 6,2014,22,0,22
Andhra Pradesh,19.3 - Under PCSO Act Section 8,2014,20,1,21
Andhra Pradesh,19.4 - Under PCSO Act Section 10,2014,1,0,1
Andhra Pradesh,19.5 - Under PCSO Act Sections 14 & 15,2014,0,0,0
Andhra Pradesh,19.6 - Other Acts of PCSO,2014,40,0,40
Andhra Pradesh,20 - Attempt to commit Murder u/s 307 IPC,2014,2,0,2
Andhra Pradesh,21 - Unnatural Offences u/s 377 IPC,2014,1,0,1
Andhra Pradesh,22 - Other crimes committed against children,2014,390,20,410
Andhra Pradesh,23 - Total crimes against Children,2014,2387,72,2459
Arunachal Pradesh,1 - Murder (Section 302 and 303 IPC),2014,3,0,3
Arunachal Pradesh,2 - Infanticide (Section 315 IPC),2014,0,0,0
Arunachal Pradesh,3 - Rape,2014,42,0,42
Arunachal Pradesh,4 - Assault on women with intent to outrage her Modesty (Section 354 IPC),2014,9,0,9
Arunachal Pradesh,4.1 - Sexual Harassment (Section 354A IPC),2014,7,0,7
Arunachal Pradesh,4.2 - Assault on women with intent to Disrobe (Section 354B IPC),2014,0,0,0
Arunachal Pradesh,4.3 - Voyeurism (Section 354C IPC),2014,1,0,1
Arunachal Pradesh,4.4 - Stalking (Section 354D IPC),2014,1,0,1
Arunachal Pradesh,4.5 - Others assault,2014,0,0,0
Arunachal Pradesh,5 - Insult to the Modesty of Women (Girls Children) (Section 509 IPC),2014,0,0,0
Arunachal Pradesh,"6 - Kidnapping & Abduction_Total (Section 363,364,364A, 366-369 IPC)",2014,46,4,50
Arunachal Pradesh,6.1 - Kidnapping & Abduction (Section 363 IPC),2014,1,0,1
Arunachal Pradesh,6.2 - Kidnaping & Abduction in order to Murder (Section 364 IPC),2014,0,0,0
Arunachal Pradesh,6.3 - Kidnapping for Ransom (Section 364A IPC),2014,1,0,1
Arunachal Pradesh,6.4 - Kidnapping & Abduction of Women to compel her for marriage (Section 366 IPC),2014,7,4,11
Arunachal Pradesh,6.5 - Other Kidnapping,2014,37,0,37
Arunachal Pradesh,7 - Foeticide (Section 315 and 316 IPC),2014,0,0,0
Arunachal Pradesh,8 - Abetment of Suicide of child (Section 305 IPC),2014,0,1,1
Arunachal Pradesh,9 - Exposure and Abandonment (Section 317 IPC),2014,0,0,0
Arunachal Pradesh,10 - Procuration of minor girls (Section 366-A IPC),2014,2,0,2
Arunachal Pradesh,11 - Importation of Girls from Foreign Country (Section 366-B IPC),2014,0,0,0
Arunachal Pradesh,12 - Buying of minors for prostitution (Section 373 IPC),2014,0,0,0
Arunachal Pradesh,13 - Selling of minors for prostitution (Section 372 IPC),2014,0,0,0
Arunachal Pradesh,"14 - Prohibition of Child Marriage Act, 2006",2014,0,0,0
Arunachal Pradesh,"15 - Transplantation of Human Organs Act, 1994",2014,0,0,0
Arunachal Pradesh,"16 - Child Labour (Prohibition & Regulation) Act, 1986",2014,0,0,0
Arunachal Pradesh,16.1 - Offences committed against Migrant,2014,0,0,0
Arunachal Pradesh,16.1.1 - Offences committed against SC migrants,2014,0,0,0
Arunachal Pradesh,16.1.2 - Offences committed against ST migrants,2014,0,0,0
Arunachal Pradesh,16.1.3 - Offences committed against others migrants,2014,0,0,0
Arunachal Pradesh,16.2 - Offences committed against Locals,2014,0,0,0
Arunachal Pradesh,16.2.1 - Offences committed against Local SCs,2014,0,0,0
Arunachal Pradesh,16.2.2 - Offences committed against Local STs,2014,0,0,0
Arunachal Pradesh,16.2.3 - Offences committed against others locals,2014,0,0,0
Arunachal Pradesh,"17 - Immoral Traffic (Prevention) Act, 1956",2014,0,0,0
Arunachal Pradesh,17.1 - Under ITP Section 5,2014,0,0,0
Arunachal Pradesh,17.2 - Under ITP Section 6,2014,0,0,0
Arunachal Pradesh,17.3 - Under ITP Section 7,2014,0,0,0
Arunachal Pradesh,17.4 - Under ITP Section 8,2014,0,0,0
Arunachal Pradesh,17.5 - Other Section of ITP Act,2014,0,0,0
Arunachal Pradesh,"18 - Juvenile Justice (Care and Protection of Children) Act, 2000",2014,0,0,0
Arunachal Pradesh,"19 - Protection of Children from Sexual Offences Act, 2012",2014,6,0,6
Arunachal Pradesh,19.1 - Under PCSO Act Section 4,2014,3,0,3
Arunachal Pradesh,19.2 - Under PCSO Act Section 6,2014,0,0,0
Arunachal Pradesh,19.3 - Under PCSO Act Section 8,2014,1,0,1
Arunachal Pradesh,19.4 - Under PCSO Act Section 10,2014,0,0,0
Arunachal Pradesh,19.5 - Under PCSO Act Sections 14 & 15,2014,0,0,0
Arunachal Pradesh,19.6 - Other Acts of PCSO,2014,2,0,2
Arunachal Pradesh,20 - Attempt to commit Murder u/s 307 IPC,2014,10,0,10
Arunachal Pradesh,21 - Unnatural Offences u/s 377 IPC,2014,0,0,0
Arunachal Pradesh,22 - Other crimes committed against children,2014,1,0,1
Arunachal Pradesh,23 - Total crimes against Children,2014,119,5,124
Assam,1 - Murder (Section 302 and 303 IPC),2014,25,0,25
Assam,2 - Infanticide (Section 315 IPC),2014,0,0,0
Assam,3 - Rape,2014,111,0,111
Assam,4 - Assault on women with intent to outrage her Modesty (Section 354 IPC),2014,70,0,70
Assam,4.1 - Sexual Harassment (Section 354A IPC),2014,16,0,16
Assam,4.2 - Assault on women with intent to Disrobe (Section 354B IPC),2014,2,0,2
Assam,4.3 - Voyeurism (Section 354C IPC),2014,0,0,0
Assam,4.4 - Stalking (Section 354D IPC),2014,0,0,0
Assam,4.5 - Others assault,2014,52,0,52
Assam,5 - Insult to the Modesty of Women (Girls Children) (Section 509 IPC),2014,0,0,0
Assam,"6 - Kidnapping & Abduction_Total (Section 363,364,364A, 366-369 IPC)",2014,152,0,152
Assam,6.1 - Kidnapping & Abduction (Section 363 IPC),2014,0,0,0
Assam,6.2 - Kidnaping & Abduction in order to Murder (Section 364 IPC),2014,0,0,0
Assam,6.3 - Kidnapping for Ransom (Section 364A IPC),2014,8,0,8
Assam,6.4 - Kidnapping & Abduction of Women to compel her for marriage (Section 366 IPC),2014,91,0,91
Assam,6.5 - Other Kidnapping,2014,53,0,53
Assam,7 - Foeticide (Section 315 and 316 IPC),2014,0,0,0
Assam,8 - Abetment of Suicide of child (Section 305 IPC),2014,0,0,0
Assam,9 - Exposure and Abandonment (Section 317 IPC),2014,0,0,0
Assam,10 - Procuration of minor girls (Section 366-A IPC),2014,303,0,303
Assam,11 - Importation of Girls from Foreign Country (Section 366-B IPC),2014,0,0,0
Assam,12 - Buying of minors for prostitution (Section 373 IPC),2014,0,0,0
Assam,13 - Selling of minors for prostitution (Section 372 IPC),2014,0,0,0
Assam,"14 - Prohibition of Child Marriage Act, 2006",2014,4,0,4
Assam,"15 - Transplantation of Human Organs Act, 1994",2014,0,0,0
Assam,"16 - Child Labour (Prohibition & Regulation) Act, 1986",2014,0,0,0
Assam,16.1 - Offences committed against Migrant,2014,0,0,0
Assam,16.1.1 - Offences committed against SC migrants,2014,0,0,0
Assam,16.1.2 - Offences committed against ST migrants,2014,0,0,0
Assam,16.1.3 - Offences committed against others migrants,2014,0,0,0
Assam,16.2 - Offences committed against Locals,2014,0,0,0
Assam,16.2.1 - Offences committed against Local SCs,2014,0,0,0
Assam,16.2.2 - Offences committed against Local STs,2014,0,0,0
Assam,16.2.3 - Offences committed against others locals,2014,0,0,0
Assam,"17 - Immoral Traffic (Prevention) Act, 1956",2014,1,0,1
Assam,17.1 - Under ITP Section 5,2014,0,0,0
Assam,17.2 - Under ITP Section 6,2014,0,0,0
Assam,17.3 - Under ITP Section 7,2014,0,0,0
Assam,17.4 - Under ITP Section 8,2014,0,0,0
Assam,17.5 - Other Section of ITP Act,2014,1,0,1
Assam,"18 - Juvenile Justice (Care and Protection of Children) Act, 2000",2014,0,0,0
Assam,"19 - Protection of Children from Sexual Offences Act, 2012",2014,278,30,308
Assam,19.1 - Under PCSO Act Section 4,2014,114,8,122
Assam,19.2 - Under PCSO Act Section 6,2014,10,6,16
Assam,19.3 - Under PCSO Act Section 8,2014,48,9,57
Assam,19.4 - Under PCSO Act Section 10,2014,26,1,27
Assam,19.5 - Under PCSO Act Sections 14 & 15,2014,0,0,0
Assam,19.6 - Other Acts of PCSO,2014,80,6,86
Assam,20 - Attempt to commit Murder u/s 307 IPC,2014,326,6,332
Assam,21 - Unnatural Offences u/s 377 IPC,2014,0,0,0
Assam,22 - Other crimes committed against children,2014,181,0,181
Assam,23 - Total crimes against Children,2014,1451,36,1487
Bihar,1 - Murder (Section 302 and 303 IPC),2014,100,0,100
Bihar,2 - Infanticide (Section 315 IPC),2014,0,0,0
Bihar,3 - Rape,2014,121,0,121
Bihar,4 - Assault on women with intent to outrage her Modesty (Section 354 IPC),2014,35,0,35
Bihar,4.1 - Sexual Harassment (Section 354A IPC),2014,15,0,15
Bihar,4.2 - Assault on women with intent to Disrobe (Section 354B IPC),2014,0,0,0
Bihar,4.3 - Voyeurism (Section 354C IPC),2014,0,0,0
Bihar,4.4 - Stalking (Section 354D IPC),2014,2,0,2
Bihar,4.5 - Others assault,2014,18,0,18
Bihar,5 - Insult to the Modesty of Women (Girls Children) (Section 509 IPC),2014,0,0,0
Bihar,"6 - Kidnapping & Abduction_Total (Section 363,364,364A, 366-369 IPC)",2014,1688,0,1688
Bihar,6.1 - Kidnapping & Abduction (Section 363 IPC),2014,113,0,113
Bihar,6.2 - Kidnaping & Abduction in order to Murder (Section 364 IPC),2014,40,0,40
Bihar,6.3 - Kidnapping for Ransom (Section 364A IPC),2014,10,0,10
Bihar,6.4 - Kidnapping & Abduction of Women to compel her for marriage (Section 366 IPC),2014,1485,0,1485
Bihar,6.5 - Other Kidnapping,2014,40,0,40
Bihar,7 - Foeticide (Section 315 and 316 IPC),2014,0,0,0
Bihar,8 - Abetment of Suicide of child (Section 305 IPC),2014,0,0,0
Bihar,9 - Exposure and Abandonment (Section 317 IPC),2014,1,0,1
Bihar,10 - Procuration of minor girls (Section 366-A IPC),2014,238,0,238
Bihar,11 - Importation of Girls from Foreign Country (Section 366-B IPC),2014,0,0,0
Bihar,12 - Buying of minors for prostitution (Section 373 IPC),2014,0,0,0
Bihar,13 - Selling of minors for prostitution (Section 372 IPC),2014,0,0,0
Bihar,"14 - Prohibition of Child Marriage Act, 2006",2014,10,0,10
Bihar,"15 - Transplantation of Human Organs Act, 1994",2014,0,0,0
Bihar,"16 - Child Labour (Prohibition & Regulation) Act, 1986",2014,4,0,4
Bihar,16.1 - Offences committed against Migrant,2014,0,0,0
Bihar,16.1.1 - Offences committed against SC migrants,2014,0,0,0
Bihar,16.1.2 - Offences committed against ST migrants,2014,0,0,0
Bihar,16.1.3 - Offences committed against others migrants,2014,0,0,0
Bihar,16.2 - Offences committed against Locals,2014,4,0,4
Bihar,16.2.1 - Offences committed against Local SCs,2014,0,0,0
Bihar,16.2.2 - Offences committed against Local STs,2014,0,0,0
Bihar,16.2.3 - Offences committed against others locals,2014,4,0,4
Bihar,"17 - Immoral Traffic (Prevention) Act, 1956",2014,3,0,3
Bihar,17.1 - Under ITP Section 5,2014,3,0,3
Bihar,17.2 - Under ITP Section 6,2014,0,0,0
Bihar,17.3 - Under ITP Section 7,2014,0,0,0
Bihar,17.4 - Under ITP Section 8,2014,0,0,0
Bihar,17.5 - Other Section of ITP Act,2014,0,0,0
Bihar,"18 - Juvenile Justice (Care and Protection of Children) Act, 2000",2014,0,0,0
Bihar,"19 - Protection of Children from Sexual Offences Act, 2012",2014,72,0,72
Bihar,19.1 - Under PCSO Act Section 4,2014,52,0,52
Bihar,19.2 - Under PCSO Act Section 6,2014,6,0,6
Bihar,19.3 - Under PCSO Act Section 8,2014,11,0,11
Bihar,19.4 - Under PCSO Act Section 10,2014,0,0,0
Bihar,19.5 - Under PCSO Act Sections 14 & 15,2014,1,0,1
Bihar,19.6 - Other Acts of PCSO,2014,2,0,2
Bihar,20 - Attempt to commit Murder u/s 307 IPC,2014,27,0,27
Bihar,21 - Unnatural Offences u/s 377 IPC,2014,3,0,3
Bihar,22 - Other crimes committed against children,2014,104,0,104
Bihar,23 - Total crimes against Children,2014,2406,0,2406
Chhattisgarh,1 - Murder (Section 302 and 303 IPC),2014,73,5,78
Chhattisgarh,2 - Infanticide (Section 315 IPC),2014,4,0,4
Chhattisgarh,3 - Rape,2014,885,5,890
Chhattisgarh,4 - Assault on women with intent to outrage her Modesty (Section 354 IPC),2014,483,1,484
Chhattisgarh,4.1 - Sexual Harassment (Section 354A IPC),2014,198,0,198
Chhattisgarh,4.2 - Assault on women with intent to Disrobe (Section 354B IPC),2014,20,0,20
Chhattisgarh,4.3 - Voyeurism (Section 354C IPC),2014,3,0,3
Chhattisgarh,4.4 - Stalking (Section 354D IPC),2014,24,0,24
Chhattisgarh,4.5 - Others assault,2014,238,1,239
Chhattisgarh,5 - Insult to the Modesty of Women (Girls Children) (Section 509 IPC),2014,15,0,15
Chhattisgarh,"6 - Kidnapping & Abduction_Total (Section 363,364,364A, 366-369 IPC)",2014,909,24,933
Chhattisgarh,6.1 - Kidnapping & Abduction (Section 363 IPC),2014,470,9,479
Chhattisgarh,6.2 - Kidnaping & Abduction in order to Murder (Section 364 IPC),2014,7,0,7
Chhattisgarh,6.3 - Kidnapping for Ransom (Section 364A IPC),2014,4,0,4
Chhattisgarh,6.4 - Kidnapping & Abduction of Women to compel her for marriage (Section 366 IPC),2014,210,2,212
Chhattisgarh,6.5 - Other Kidnapping,2014,218,13,231
Chhattisgarh,7 - Foeticide (Section 315 and 316 IPC),2014,0,0,0
Chhattisgarh,8 - Abetment of Suicide of child (Section 305 IPC),2014,1,0,1
Chhattisgarh,9 - Exposure and Abandonment (Section 317 IPC),2014,0,1,1
Chhattisgarh,10 - Procuration of minor girls (Section 366-A IPC),2014,1,2,3
Chhattisgarh,11 - Importation of Girls from Foreign Country (Section 366-B IPC),2014,0,0,0
Chhattisgarh,12 - Buying of minors for prostitution (Section 373 IPC),2014,0,0,0
Chhattisgarh,13 - Selling of minors for prostitution (Section 372 IPC),2014,2,3,5
Chhattisgarh,"14 - Prohibition of Child Marriage Act, 2006",2014,4,0,4
Chhattisgarh,"15 - Transplantation of Human Organs Act, 1994",2014,0,0,0
Chhattisgarh,"16 - Child Labour (Prohibition & Regulation) Act, 1986",2014,0,0,0
Chhattisgarh,16.1 - Offences committed against Migrant,2014,0,0,0
Chhattisgarh,16.1.1 - Offences committed against SC migrants,2014,0,0,0
Chhattisgarh,16.1.2 - Offences committed against ST migrants,2014,0,0,0
Chhattisgarh,16.1.3 - Offences committed against others migrants,2014,0,0,0
Chhattisgarh,16.2 - Offences committed against Locals,2014,0,0,0
Chhattisgarh,16.2.1 - Offences committed against Local SCs,2014,0,0,0
Chhattisgarh,16.2.2 - Offences committed against Local STs,2014,0,0,0
Chhattisgarh,16.2.3 - Offences committed against others locals,2014,0,0,0
Chhattisgarh,"17 - Immoral Traffic (Prevention) Act, 1956",2014,0,0,0
Chhattisgarh,17.1 - Under ITP Section 5,2014,0,0,0
Chhattisgarh,17.2 - Under ITP Section 6,2014,0,0,0
Chhattisgarh,17.3 - Under ITP Section 7,2014,0,0,0
Chhattisgarh,17.4 - Under ITP Section 8,2014,0,0,0
Chhattisgarh,17.5 - Other Section of ITP Act,2014,0,0,0
Chhattisgarh,"18 - Juvenile Justice (Care and Protection of Children) Act, 2000",2014,0,0,0
Chhattisgarh,"19 - Protection of Children from Sexual Offences Act, 2012",2014,343,72,415
Chhattisgarh,19.1 - Under PCSO Act Section 4,2014,168,34,202
Chhattisgarh,19.2 - Under PCSO Act Section 6,2014,19,1,20
Chhattisgarh,19.3 - Under PCSO Act Section 8,2014,81,7,88
Chhattisgarh,19.4 - Under PCSO Act Section 10,2014,10,30,40
Chhattisgarh,19.5 - Under PCSO Act Sections 14 & 15,2014,2,0,2
Chhattisgarh,19.6 - Other Acts of PCSO,2014,63,0,63
Chhattisgarh,20 - Attempt to commit Murder u/s 307 IPC,2014,263,7,270
Chhattisgarh,21 - Unnatural Offences u/s 377 IPC,2014,22,0,22
Chhattisgarh,22 - Other crimes committed against children,2014,722,64,786
Chhattisgarh,23 - Total crimes against Children,2014,3727,184,3911
Goa,1 - Murder (Section 302 and 303 IPC),2014,5,0,5
Goa,2 - Infanticide (Section 315 IPC),2014,0,0,0
Goa,3 - Rape,2014,67,3,70
Goa,4 - Assault on women with intent to outrage her Modesty (Section 354 IPC),2014,42,1,43
Goa,4.1 - Sexual Harassment (Section 354A IPC),2014,19,1,20
Goa,4.2 - Assault on women with intent to Disrobe (Section 354B IPC),2014,2,0,2
Goa,4.3 - Voyeurism (Section 354C IPC),2014,0,0,0
Goa,4.4 - Stalking (Section 354D IPC),2014,5,0,5
Goa,4.5 - Others assault,2014,16,0,16
Goa,5 - Insult to the Modesty of Women (Girls Children) (Section 509 IPC),2014,1,0,1
Goa,"6 - Kidnapping & Abduction_Total (Section 363,364,364A, 366-369 IPC)",2014,34,6,40
Goa,6.1 - Kidnapping & Abduction (Section 363 IPC),2014,34,6,40
Goa,6.2 - Kidnaping & Abduction in order to Murder (Section 364 IPC),2014,0,0,0
Goa,6.3 - Kidnapping for Ransom (Section 364A IPC),2014,0,0,0
Goa,6.4 - Kidnapping & Abduction of Women to compel her for marriage (Section 366 IPC),2014,0,0,0
Goa,6.5 - Other Kidnapping,2014,0,0,0
Goa,7 - Foeticide (Section 315 and 316 IPC),2014,0,0,0
Goa,8 - Abetment of Suicide of child (Section 305 IPC),2014,0,0,0
Goa,9 - Exposure and Abandonment (Section 317 IPC),2014,0,0,0
Goa,10 - Procuration of minor girls (Section 366-A IPC),2014,0,0,0
Goa,11 - Importation of Girls from Foreign Country (Section 366-B IPC),2014,0,0,0
Goa,12 - Buying of minors for prostitution (Section 373 IPC),2014,0,0,0
Goa,13 - Selling of minors for prostitution (Section 372 IPC),2014,0,0,0
Goa,"14 - Prohibition of Child Marriage Act, 2006",2014,0,0,0
Goa,"15 - Transplantation of Human Organs Act, 1994",2014,0,0,0
Goa,"16 - Child Labour (Prohibition & Regulation) Act, 1986",2014,0,0,0
Goa,16.1 - Offences committed against Migrant,2014,0,0,0
Goa,16.1.1 - Offences committed against SC migrants,2014,0,0,0
Goa,16.1.2 - Offences committed against ST migrants,2014,0,0,0
Goa,16.1.3 - Offences committed against others migrants,2014,0,0,0
Goa,16.2 - Offences committed against Locals,2014,0,0,0
Goa,16.2.1 - Offences committed against Local SCs,2014,0,0,0
Goa,16.2.2 - Offences committed against Local STs,2014,0,0,0
Goa,16.2.3 - Offences committed against others locals,2014,0,0,0
Goa,"17 - Immoral Traffic (Prevention) Act, 1956",2014,0,0,0
Goa,17.1 - Under ITP Section 5,2014,0,0,0
Goa,17.2 - Under ITP Section 6,2014,0,0,0
Goa,17.3 - Under ITP Section 7,2014,0,0,0
Goa,17.4 - Under ITP Section 8,2014,0,0,0
Goa,17.5 - Other Section of ITP Act,2014,0,0,0
Goa,"18 - Juvenile Justice (Care and Protection of Children) Act, 2000",2014,2,0,2
Goa,"19 - Protection of Children from Sexual Offences Act, 2012",2014,2,0,2
Goa,19.1 - Under PCSO Act Section 4,2014,0,0,0
Goa,19.2 - Under PCSO Act Section 6,2014,0,0,0
Goa,19.3 - Under PCSO Act Section 8,2014,2,0,2
Goa,19.4 - Under PCSO Act Section 10,2014,0,0,0
Goa,19.5 - Under PCSO Act Sections 14 & 15,2014,0,0,0
Goa,19.6 - Other Acts of PCSO,2014,0,0,0
Goa,20 - Attempt to commit Murder u/s 307 IPC,2014,2,0,2
Goa,21 - Unnatural Offences u/s 377 IPC,2014,0,0,0
Goa,22 - Other crimes committed against children,2014,70,21,91
Goa,23 - Total crimes against Children,2014,225,31,256
Gujarat,1 - Murder (Section 302 and 303 IPC),2014,50,18,68
Gujarat,2 - Infanticide (Section 315 IPC),2014,0,0,0
Gujarat,3 - Rape,2014,384,13,397
Gujarat,4 - Assault on women with intent to outrage her Modesty (Section 354 IPC),2014,258,3,261
Gujarat,4.1 - Sexual Harassment (Section 354A IPC),2014,130,2,132
Gujarat,4.2 - Assault on women with intent to Disrobe (Section 354B IPC),2014,7,1,8
Gujarat,4.3 - Voyeurism (Section 354C IPC),2014,0,0,0
Gujarat,4.4 - Stalking (Section 354D IPC),2014,24,0,24
Gujarat,4.5 - Others assault,2014,97,0,97
Gujarat,5 - Insult to the Modesty of Women (Girls Children) (Section 509 IPC),2014,4,0,4
Gujarat,"6 - Kidnapping & Abduction_Total (Section 363,364,364A, 366-369 IPC)",2014,1768,51,1819
Gujarat,6.1 - Kidnapping & Abduction (Section 363 IPC),2014,597,25,622
Gujarat,6.2 - Kidnaping & Abduction in order to Murder (Section 364 IPC),2014,0,0,0
Gujarat,6.3 - Kidnapping for Ransom (Section 364A IPC),2014,12,3,15
Gujarat,6.4 - Kidnapping & Abduction of Women to compel her for marriage (Section 366 IPC),2014,963,15,978
Gujarat,6.5 - Other Kidnapping,2014,196,8,204
Gujarat,7 - Foeticide (Section 315 and 316 IPC),2014,0,0,0
Gujarat,8 - Abetment of Suicide of child (Section 305 IPC),2014,0,0,0
Gujarat,9 - Exposure and Abandonment (Section 317 IPC),2014,12,9,21
Gujarat,10 - Procuration of minor girls (Section 366-A IPC),2014,0,0,0
Gujarat,11 - Importation of Girls from Foreign Country (Section 366-B IPC),2014,0,0,0
Gujarat,12 - Buying of minors for prostitution (Section 373 IPC),2014,0,0,0
Gujarat,13 - Selling of minors for prostitution (Section 372 IPC),2014,0,0,0
Gujarat,"14 - Prohibition of Child Marriage Act, 2006",2014,51,25,76
Gujarat,"15 - Transplantation of Human Organs Act, 1994",2014,0,0,0
Gujarat,"16 - Child Labour (Prohibition & Regulation) Act, 1986",2014,2,0,2
Gujarat,16.1 - Offences committed against Migrant,2014,0,0,0
Gujarat,16.1.1 - Offences committed against SC migrants,2014,0,0,0
Gujarat,16.1.2 - Offences committed against ST migrants,2014,0,0,0
Gujarat,16.1.3 - Offences committed against others migrants,2014,0,0,0
Gujarat,16.2 - Offences committed against Locals,2014,2,0,2
Gujarat,16.2.1 - Offences committed against Local SCs,2014,0,0,0
Gujarat,16.2.2 - Offences committed against Local STs,2014,0,0,0
Gujarat,16.2.3 - Offences committed against others locals,2014,2,0,2
Gujarat,"17 - Immoral Traffic (Prevention) Act, 1956",2014,2,1,3
Gujarat,17.1 - Under ITP Section 5,2014,0,0,0
Gujarat,17.2 - Under ITP Section 6,2014,0,0,0
Gujarat,17.3 - Under ITP Section 7,2014,0,0,0
Gujarat,17.4 - Under ITP Section 8,2014,2,1,3
Gujarat,17.5 - Other Section of ITP Act,2014,0,0,0
Gujarat,"18 - Juvenile Justice (Care and Protection of Children) Act, 2000",2014,90,4,94
Gujarat,"19 - Protection of Children from Sexual Offences Act, 2012",2014,111,6,117
Gujarat,19.1 - Under PCSO Act Section 4,2014,53,0,53
Gujarat,19.2 - Under PCSO Act Section 6,2014,38,1,39
Gujarat,19.3 - Under PCSO Act Section 8,2014,4,0,4
Gujarat,19.4 - Under PCSO Act Section 10,2014,5,0,5
Gujarat,19.5 - Under PCSO Act Sections 14 & 15,2014,3,0,3
Gujarat,19.6 - Other Acts of PCSO,2014,8,5,13
Gujarat,20 - Attempt to commit Murder u/s 307 IPC,2014,83,7,90
Gujarat,21 - Unnatural Offences u/s 377 IPC,2014,20,1,21
Gujarat,22 - Other crimes committed against children,2014,229,9,238
Gujarat,23 - Total crimes against Children,2014,3064,147,3211
Haryana,1 - Murder (Section 302 and 303 IPC),2014,68,3,71
Haryana,2 - Infanticide (Section 315 IPC),2014,0,0,0
Haryana,3 - Rape,2014,487,15,502
Haryana,4 - Assault on women with intent to outrage her Modesty (Section 354 IPC),2014,320,0,320
Haryana,4.1 - Sexual Harassment (Section 354A IPC),2014,126,0,126
Haryana,4.2 - Assault on women with intent to Disrobe (Section 354B IPC),2014,41,0,41
Haryana,4.3 - Voyeurism (Section 354C IPC),2014,4,0,4
Haryana,4.4 - Stalking (Section 354D IPC),2014,58,0,58
Haryana,4.5 - Others assault,2014,91,0,91
Haryana,5 - Insult to the Modesty of Women (Girls Children) (Section 509 IPC),2014,2,0,2
Haryana,"6 - Kidnapping & Abduction_Total (Section 363,364,364A, 366-369 IPC)",2014,374,7,381
Haryana,6.1 - Kidnapping & Abduction (Section 363 IPC),2014,42,0,42
Haryana,6.2 - Kidnaping & Abduction in order to Murder (Section 364 IPC),2014,18,3,21
Haryana,6.3 - Kidnapping for Ransom (Section 364A IPC),2014,10,0,10
Haryana,6.4 - Kidnapping & Abduction of Women to compel her for marriage (Section 366 IPC),2014,139,2,141
Haryana,6.5 - Other Kidnapping,2014,165,2,167
Haryana,7 - Foeticide (Section 315 and 316 IPC),2014,2,0,2
Haryana,8 - Abetment of Suicide of child (Section 305 IPC),2014,2,0,2
Haryana,9 - Exposure and Abandonment (Section 317 IPC),2014,2,0,2
Haryana,10 - Procuration of minor girls (Section 366-A IPC),2014,272,0,272
Haryana,11 - Importation of Girls from Foreign Country (Section 366-B IPC),2014,0,0,0
Haryana,12 - Buying of minors for prostitution (Section 373 IPC),2014,1,1,2
Haryana,13 - Selling of minors for prostitution (Section 372 IPC),2014,0,0,0
Haryana,"14 - Prohibition of Child Marriage Act, 2006",2014,15,1,16
Haryana,"15 - Transplantation of Human Organs Act, 1994",2014,0,0,0
Haryana,"16 - Child Labour (Prohibition & Regulation) Act, 1986",2014,0,0,0
Haryana,16.1 - Offences committed against Migrant,2014,0,0,0
Haryana,16.1.1 - Offences committed against SC migrants,2014,0,0,0
Haryana,16.1.2 - Offences committed against ST migrants,2014,0,0,0
Haryana,16.1.3 - Offences committed against others migrants,2014,0,0,0
Haryana,16.2 - Offences committed against Locals,2014,0,0,0
Haryana,16.2.1 - Offences committed against Local SCs,2014,0,0,0
Haryana,16.2.2 - Offences committed against Local STs,2014,0,0,0
Haryana,16.2.3 - Offences committed against others locals,2014,0,0,0
Haryana,"17 - Immoral Traffic (Prevention) Act, 1956",2014,2,4,6
Haryana,17.1 - Under ITP Section 5,2014,0,0,0
Haryana,17.2 - Under ITP Section 6,2014,0,0,0
Haryana,17.3 - Under ITP Section 7,2014,0,0,0
Haryana,17.4 - Under ITP Section 8,2014,0,0,0
Haryana,17.5 - Other Section of ITP Act,2014,2,4,6
Haryana,"18 - Juvenile Justice (Care and Protection of Children) Act, 2000",2014,50,3,53
Haryana,"19 - Protection of Children from Sexual Offences Act, 2012",2014,2,0,2
Haryana,19.1 - Under PCSO Act Section 4,2014,1,0,1
Haryana,19.2 - Under PCSO Act Section 6,2014,0,0,0
Haryana,19.3 - Under PCSO Act Section 8,2014,0,0,0
Haryana,19.4 - Under PCSO Act Section 10,2014,0,0,0
Haryana,19.5 - Under PCSO Act Sections 14 & 15,2014,0,0,0
Haryana,19.6 - Other Acts of PCSO,2014,1,0,1
Haryana,20 - Attempt to commit Murder u/s 307 IPC,2014,59,2,61
Haryana,21 - Unnatural Offences u/s 377 IPC,2014,119,0,119
Haryana,22 - Other crimes committed against children,2014,227,6,233
Haryana,23 - Total crimes against Children,2014,2004,42,2046
Himachal Pradesh,1 - Murder (Section 302 and 303 IPC),2014,9,1,10
Himachal Pradesh,2 - Infanticide (Section 315 IPC),2014,0,0,0
Himachal Pradesh,3 - Rape,2014,158,4,162
Himachal Pradesh,4 - Assault on women with intent to outrage her Modesty (Section 354 IPC),2014,65,0,65
Himachal Pradesh,4.1 - Sexual Harassment (Section 354A IPC),2014,21,0,21
Himachal Pradesh,4.2 - Assault on women with intent to Disrobe (Section 354B IPC),2014,1,0,1
Himachal Pradesh,4.3 - Voyeurism (Section 354C IPC),2014,0,0,0
Himachal Pradesh,4.4 - Stalking (Section 354D IPC),2014,18,0,18
Himachal Pradesh,4.5 - Others assault,2014,25,0,25
Himachal Pradesh,5 - Insult to the Modesty of Women (Girls Children) (Section 509 IPC),2014,0,0,0
Himachal Pradesh,"6 - Kidnapping & Abduction_Total (Section 363,364,364A, 366-369 IPC)",2014,88,4,92
Himachal Pradesh,6.1 - Kidnapping & Abduction (Section 363 IPC),2014,15,0,15
Himachal Pradesh,6.2 - Kidnaping & Abduction in order to Murder (Section 364 IPC),2014,0,0,0
Himachal Pradesh,6.3 - Kidnapping for Ransom (Section 364A IPC),2014,1,0,1
Himachal Pradesh,6.4 - Kidnapping & Abduction of Women to compel her for marriage (Section 366 IPC),2014,59,2,61
Himachal Pradesh,6.5 - Other Kidnapping,2014,13,2,15
Himachal Pradesh,7 - Foeticide (Section 315 and 316 IPC),2014,0,0,0
Himachal Pradesh,8 - Abetment of Suicide of child (Section 305 IPC),2014,2,1,3
Himachal Pradesh,9 - Exposure and Abandonment (Section 317 IPC),2014,0,2,2
Himachal Pradesh,10 - Procuration of minor girls (Section 366-A IPC),2014,2,0,2
Himachal Pradesh,11 - Importation of Girls from Foreign Country (Section 366-B IPC),2014,0,0,0
Himachal Pradesh,12 - Buying of minors for prostitution (Section 373 IPC),2014,0,0,0
Himachal Pradesh,13 - Selling of minors for prostitution (Section 372 IPC),2014,0,0,0
Himachal Pradesh,"14 - Prohibition of Child Marriage Act, 2006",2014,11,7,18
Himachal Pradesh,"15 - Transplantation of Human Organs Act, 1994",2014,0,0,0
Himachal Pradesh,"16 - Child Labour (Prohibition & Regulation) Act, 1986",2014,0,0,0
Himachal Pradesh,16.1 - Offences committed against Migrant,2014,0,0,0
Himachal Pradesh,16.1.1 - Offences committed against SC migrants,2014,0,0,0
Himachal Pradesh,16.1.2 - Offences committed against ST migrants,2014,0,0,0
Himachal Pradesh,16.1.3 - Offences committed against others migrants,2014,0,0,0
Himachal Pradesh,16.2 - Offences committed against Locals,2014,0,0,0
Himachal Pradesh,16.2.1 - Offences committed against Local SCs,2014,0,0,0
Himachal Pradesh,16.2.2 - Offences committed against Local STs,2014,0,0,0
Himachal Pradesh,16.2.3 - Offences committed against others locals,2014,0,0,0
Himachal Pradesh,"17 - Immoral Traffic (Prevention) Act, 1956",2014,0,0,0
Himachal Pradesh,17.1 - Under ITP Section 5,2014,0,0,0
Himachal Pradesh,17.2 - Under ITP Section 6,2014,0,0,0
Himachal Pradesh,17.3 - Under ITP Section 7,2014,0,0,0
Himachal Pradesh,17.4 - Under ITP Section 8,2014,0,0,0
Himachal Pradesh,17.5 - Other Section of ITP Act,2014,0,0,0
Himachal Pradesh,"18 - Juvenile Justice (Care and Protection of Children) Act, 2000",2014,8,4,12
Himachal Pradesh,"19 - Protection of Children from Sexual Offences Act, 2012",2014,19,0,19
Himachal Pradesh,19.1 - Under PCSO Act Section 4,2014,13,0,13
Himachal Pradesh,19.2 - Under PCSO Act Section 6,2014,3,0,3
Himachal Pradesh,19.3 - Under PCSO Act Section 8,2014,2,0,2
Himachal Pradesh,19.4 - Under PCSO Act Section 10,2014,0,0,0
Himachal Pradesh,19.5 - Under PCSO Act Sections 14 & 15,2014,0,0,0
Himachal Pradesh,19.6 - Other Acts of PCSO,2014,1,0,1
Himachal Pradesh,20 - Attempt to commit Murder u/s 307 IPC,2014,0,0,0
Himachal Pradesh,21 - Unnatural Offences u/s 377 IPC,2014,11,0,11
Himachal Pradesh,22 - Other crimes committed against children,2014,6,2,8
Himachal Pradesh,23 - Total crimes against Children,2014,379,25,404
Jammu & Kashmir,1 - Murder (Section 302 and 303 IPC),2014,3,0,3
Jammu & Kashmir,2 - Infanticide (Section 315 IPC),2014,0,0,0
Jammu & Kashmir,3 - Rape,2014,37,0,37
Jammu & Kashmir,4 - Assault on women with intent to outrage her Modesty (Section 354 IPC),2014,8,0,8
Jammu & Kashmir,4.1 - Sexual Harassment (Section 354A IPC),2014,1,0,1
Jammu & Kashmir,4.2 - Assault on women with intent to Disrobe (Section 354B IPC),2014,0,0,0
Jammu & Kashmir,4.3 - Voyeurism (Section 354C IPC),2014,0,0,0
Jammu & Kashmir,4.4 - Stalking (Section 354D IPC),2014,0,0,0
Jammu & Kashmir,4.5 - Others assault,2014,7,0,7
Jammu & Kashmir,5 - Insult to the Modesty of Women (Girls Children) (Section 509 IPC),2014,1,0,1
Jammu & Kashmir,"6 - Kidnapping & Abduction_Total (Section 363,364,364A, 366-369 IPC)",2014,120,2,122
Jammu & Kashmir,6.1 - Kidnapping & Abduction (Section 363 IPC),2014,120,2,122
Jammu & Kashmir,6.2 - Kidnaping & Abduction in order to Murder (Section 364 IPC),2014,0,0,0
Jammu & Kashmir,6.3 - Kidnapping for Ransom (Section 364A IPC),2014,0,0,0
Jammu & Kashmir,6.4 - Kidnapping & Abduction of Women to compel her for marriage (Section 366 IPC),2014,0,0,0
Jammu & Kashmir,6.5 - Other Kidnapping,2014,0,0,0
Jammu & Kashmir,7 - Foeticide (Section 315 and 316 IPC),2014,0,0,0
Jammu & Kashmir,8 - Abetment of Suicide of child (Section 305 IPC),2014,0,0,0
Jammu & Kashmir,9 - Exposure and Abandonment (Section 317 IPC),2014,3,1,4
Jammu & Kashmir,10 - Procuration of minor girls (Section 366-A IPC),2014,0,0,0
Jammu & Kashmir,11 - Importation of Girls from Foreign Country (Section 366-B IPC),2014,0,0,0
Jammu & Kashmir,12 - Buying of minors for prostitution (Section 373 IPC),2014,0,0,0
Jammu & Kashmir,13 - Selling of minors for prostitution (Section 372 IPC),2014,0,0,0
Jammu & Kashmir,"14 - Prohibition of Child Marriage Act, 2006",2014,0,0,0
Jammu & Kashmir,"15 - Transplantation of Human Organs Act, 1994",2014,0,0,0
Jammu & Kashmir,"16 - Child Labour (Prohibition & Regulation) Act, 1986",2014,0,0,0
Jammu & Kashmir,16.1 - Offences committed against Migrant,2014,0,0,0
Jammu & Kashmir,16.1.1 - Offences committed against SC migrants,2014,0,0,0
Jammu & Kashmir,16.1.2 - Offences committed against ST migrants,2014,0,0,0
Jammu & Kashmir,16.1.3 - Offences committed against others migrants,2014,0,0,0
Jammu & Kashmir,16.2 - Offences committed against Locals,2014,0,0,0
Jammu & Kashmir,16.2.1 - Offences committed against Local SCs,2014,0,0,0
Jammu & Kashmir,16.2.2 - Offences committed against Local STs,2014,0,0,0
Jammu & Kashmir,16.2.3 - Offences committed against others locals,2014,0,0,0
Jammu & Kashmir,"17 - Immoral Traffic (Prevention) Act, 1956",2014,0,0,0
Jammu & Kashmir,17.1 - Under ITP Section 5,2014,0,0,0
Jammu & Kashmir,17.2 - Under ITP Section 6,2014,0,0,0
Jammu & Kashmir,17.3 - Under ITP Section 7,2014,0,0,0
Jammu & Kashmir,17.4 - Under ITP Section 8,2014,0,0,0
Jammu & Kashmir,17.5 - Other Section of ITP Act,2014,0,0,0
Jammu & Kashmir,"18 - Juvenile Justice (Care and Protection of Children) Act, 2000",2014,0,0,0
Jammu & Kashmir,"19 - Protection of Children from Sexual Offences Act, 2012",2014,0,0,0
Jammu & Kashmir,19.1 - Under PCSO Act Section 4,2014,0,0,0
Jammu & Kashmir,19.2 - Under PCSO Act Section 6,2014,0,0,0
Jammu & Kashmir,19.3 - Under PCSO Act Section 8,2014,0,0,0
Jammu & Kashmir,19.4 - Under PCSO Act Section 10,2014,0,0,0
Jammu & Kashmir,19.5 - Under PCSO Act Sections 14 & 15,2014,0,0,0
Jammu & Kashmir,19.6 - Other Acts of PCSO,2014,0,0,0
Jammu & Kashmir,20 - Attempt to commit Murder u/s 307 IPC,2014,4,0,4
Jammu & Kashmir,21 - Unnatural Offences u/s 377 IPC,2014,11,0,11
Jammu & Kashmir,22 - Other crimes committed against children,2014,0,0,0
Jammu & Kashmir,23 - Total crimes against Children,2014,187,3,190
Jharkhand,1 - Murder (Section 302 and 303 IPC),2014,5,0,5
Jharkhand,2 - Infanticide (Section 315 IPC),2014,2,0,2
Jharkhand,3 - Rape,2014,100,0,100
Jharkhand,4 - Assault on women with intent to outrage her Modesty (Section 354 IPC),2014,3,0,3
Jharkhand,4.1 - Sexual Harassment (Section 354A IPC),2014,2,0,2
Jharkhand,4.2 - Assault on women with intent to Disrobe (Section 354B IPC),2014,0,0,0
Jharkhand,4.3 - Voyeurism (Section 354C IPC),2014,0,0,0
Jharkhand,4.4 - Stalking (Section 354D IPC),2014,0,0,0
Jharkhand,4.5 - Others assault,2014,1,0,1
Jharkhand,5 - Insult to the Modesty of Women (Girls Children) (Section 509 IPC),2014,0,0,0
Jharkhand,"6 - Kidnapping & Abduction_Total (Section 363,364,364A, 366-369 IPC)",2014,92,0,92
Jharkhand,6.1 - Kidnapping & Abduction (Section 363 IPC),2014,10,0,10
Jharkhand,6.2 - Kidnaping & Abduction in order to Murder (Section 364 IPC),2014,0,0,0
Jharkhand,6.3 - Kidnapping for Ransom (Section 364A IPC),2014,2,0,2
Jharkhand,6.4 - Kidnapping & Abduction of Women to compel her for marriage (Section 366 IPC),2014,63,0,63
Jharkhand,6.5 - Other Kidnapping,2014,17,0,17
Jharkhand,7 - Foeticide (Section 315 and 316 IPC),2014,1,0,1
Jharkhand,8 - Abetment of Suicide of child (Section 305 IPC),2014,0,0,0
Jharkhand,9 - Exposure and Abandonment (Section 317 IPC),2014,0,0,0
Jharkhand,10 - Procuration of minor girls (Section 366-A IPC),2014,17,0,17
Jharkhand,11 - Importation of Girls from Foreign Country (Section 366-B IPC),2014,0,0,0
Jharkhand,12 - Buying of minors for prostitution (Section 373 IPC),2014,4,0,4
Jharkhand,13 - Selling of minors for prostitution (Section 372 IPC),2014,0,0,0
Jharkhand,"14 - Prohibition of Child Marriage Act, 2006",2014,1,0,1
Jharkhand,"15 - Transplantation of Human Organs Act, 1994",2014,0,0,0
Jharkhand,"16 - Child Labour (Prohibition & Regulation) Act, 1986",2014,0,0,0
Jharkhand,16.1 - Offences committed against Migrant,2014,0,0,0
Jharkhand,16.1.1 - Offences committed against SC migrants,2014,0,0,0
Jharkhand,16.1.2 - Offences committed against ST migrants,2014,0,0,0
Jharkhand,16.1.3 - Offences committed against others migrants,2014,0,0,0
Jharkhand,16.2 - Offences committed against Locals,2014,0,0,0
Jharkhand,16.2.1 - Offences committed against Local SCs,2014,0,0,0
Jharkhand,16.2.2 - Offences committed against Local STs,2014,0,0,0
Jharkhand,16.2.3 - Offences committed against others locals,2014,0,0,0
Jharkhand,"17 - Immoral Traffic (Prevention) Act, 1956",2014,1,0,1
Jharkhand,17.1 - Under ITP Section 5,2014,1,0,1
Jharkhand,17.2 - Under ITP Section 6,2014,0,0,0
Jharkhand,17.3 - Under ITP Section 7,2014,0,0,0
Jharkhand,17.4 - Under ITP Section 8,2014,0,0,0
Jharkhand,17.5 - Other Section of ITP Act,2014,0,0,0
Jharkhand,"18 - Juvenile Justice (Care and Protection of Children) Act, 2000",2014,1,0,1
Jharkhand,"19 - Protection of Children from Sexual Offences Act, 2012",2014,33,0,33
Jharkhand,19.1 - Under PCSO Act Section 4,2014,3,0,3
Jharkhand,19.2 - Under PCSO Act Section 6,2014,2,0,2
Jharkhand,19.3 - Under PCSO Act Section 8,2014,7,0,7
Jharkhand,19.4 - Under PCSO Act Section 10,2014,0,0,0
Jharkhand,19.5 - Under PCSO Act Sections 14 & 15,2014,0,0,0
Jharkhand,19.6 - Other Acts of PCSO,2014,21,0,21
Jharkhand,20 - Attempt to commit Murder u/s 307 IPC,2014,195,8,203
Jharkhand,21 - Unnatural Offences u/s 377 IPC,2014,9,0,9
Jharkhand,22 - Other crimes committed against children,2014,34,3,37
Jharkhand,23 - Total crimes against Children,2014,498,11,509
Karnataka,1 - Murder (Section 302 and 303 IPC),2014,92,10,102
Karnataka,2 - Infanticide (Section 315 IPC),2014,8,0,8
Karnataka,3 - Rape,2014,798,9,807
Karnataka,4 - Assault on women with intent to outrage her Modesty (Section 354 IPC),2014,62,2,64
Karnataka,4.1 - Sexual Harassment (Section 354A IPC),2014,10,0,10
Karnataka,4.2 - Assault on women with intent to Disrobe (Section 354B IPC),2014,2,0,2
Karnataka,4.3 - Voyeurism (Section 354C IPC),2014,0,0,0
Karnataka,4.4 - Stalking (Section 354D IPC),2014,3,0,3
Karnataka,4.5 - Others assault,2014,47,2,49
Karnataka,5 - Insult to the Modesty of Women (Girls Children) (Section 509 IPC),2014,0,0,0
Karnataka,"6 - Kidnapping & Abduction_Total (Section 363,364,364A, 366-369 IPC)",2014,703,18,721
Karnataka,6.1 - Kidnapping & Abduction (Section 363 IPC),2014,334,6,340
Karnataka,6.2 - Kidnaping & Abduction in order to Murder (Section 364 IPC),2014,0,0,0
Karnataka,6.3 - Kidnapping for Ransom (Section 364A IPC),2014,34,2,36
Karnataka,6.4 - Kidnapping & Abduction of Women to compel her for marriage (Section 366 IPC),2014,130,5,135
Karnataka,6.5 - Other Kidnapping,2014,205,5,210
Karnataka,7 - Foeticide (Section 315 and 316 IPC),2014,0,0,0
Karnataka,8 - Abetment of Suicide of child (Section 305 IPC),2014,0,0,0
Karnataka,9 - Exposure and Abandonment (Section 317 IPC),2014,25,12,37
Karnataka,10 - Procuration of minor girls (Section 366-A IPC),2014,55,1,56
Karnataka,11 - Importation of Girls from Foreign Country (Section 366-B IPC),2014,0,0,0
Karnataka,12 - Buying of minors for prostitution (Section 373 IPC),2014,0,0,0
Karnataka,13 - Selling of minors for prostitution (Section 372 IPC),2014,0,0,0
Karnataka,"14 - Prohibition of Child Marriage Act, 2006",2014,58,8,66
Karnataka,"15 - Transplantation of Human Organs Act, 1994",2014,0,0,0
Karnataka,"16 - Child Labour (Prohibition & Regulation) Act, 1986",2014,4,0,4
Karnataka,16.1 - Offences committed against Migrant,2014,0,0,0
Karnataka,16.1.1 - Offences committed against SC migrants,2014,0,0,0
Karnataka,16.1.2 - Offences committed against ST migrants,2014,0,0,0
Karnataka,16.1.3 - Offences committed against others migrants,2014,0,0,0
Karnataka,16.2 - Offences committed against Locals,2014,4,0,4
Karnataka,16.2.1 - Offences committed against Local SCs,2014,0,0,0
Karnataka,16.2.2 - Offences committed against Local STs,2014,0,0,0
Karnataka,16.2.3 - Offences committed against others locals,2014,4,0,4
Karnataka,"17 - Immoral Traffic (Prevention) Act, 1956",2014,11,2,13
Karnataka,17.1 - Under ITP Section 5,2014,0,0,0
Karnataka,17.2 - Under ITP Section 6,2014,0,0,0
Karnataka,17.3 - Under ITP Section 7,2014,3,2,5
Karnataka,17.4 - Under ITP Section 8,2014,0,0,0
Karnataka,17.5 - Other Section of ITP Act,2014,8,0,8
Karnataka,"18 - Juvenile Justice (Care and Protection of Children) Act, 2000",2014,73,11,84
Karnataka,"19 - Protection of Children from Sexual Offences Act, 2012",2014,656,11,667
Karnataka,19.1 - Under PCSO Act Section 4,2014,251,8,259
Karnataka,19.2 - Under PCSO Act Section 6,2014,78,0,78
Karnataka,19.3 - Under PCSO Act Section 8,2014,69,0,69
Karnataka,19.4 - Under PCSO Act Section 10,2014,13,0,13
Karnataka,19.5 - Under PCSO Act Sections 14 & 15,2014,3,0,3
Karnataka,19.6 - Other Acts of PCSO,2014,242,3,245
Karnataka,20 - Attempt to commit Murder u/s 307 IPC,2014,345,3,348
Karnataka,21 - Unnatural Offences u/s 377 IPC,2014,3,0,3
Karnataka,22 - Other crimes committed against children,2014,463,6,469
Karnataka,23 - Total crimes against Children,2014,3356,93,3449
Kerala,1 - Murder (Section 302 and 303 IPC),2014,32,15,47
Kerala,2 - Infanticide (Section 315 IPC),2014,0,0,0
Kerala,3 - Rape,2014,836,12,848
Kerala,4 - Assault on women with intent to outrage her Modesty (Section 354 IPC),2014,200,0,200
Kerala,4.1 - Sexual Harassment (Section 354A IPC),2014,87,0,87
Kerala,4.2 - Assault on women with intent to Disrobe (Section 354B IPC),2014,5,0,5
Kerala,4.3 - Voyeurism (Section 354C IPC),2014,2,0,2
Kerala,4.4 - Stalking (Section 354D IPC),2014,8,0,8
Kerala,4.5 - Others assault,2014,98,0,98
Kerala,5 - Insult to the Modesty of Women (Girls Children) (Section 509 IPC),2014,2,0,2
Kerala,"6 - Kidnapping & Abduction_Total (Section 363,364,364A, 366-369 IPC)",2014,157,3,160
Kerala,6.1 - Kidnapping & Abduction (Section 363 IPC),2014,31,0,31
Kerala,6.2 - Kidnaping & Abduction in order to Murder (Section 364 IPC),2014,0,0,0
Kerala,6.3 - Kidnapping for Ransom (Section 364A IPC),2014,0,0,0
Kerala,6.4 - Kidnapping & Abduction of Women to compel her for marriage (Section 366 IPC),2014,87,1,88
Kerala,6.5 - Other Kidnapping,2014,39,2,41
Kerala,7 - Foeticide (Section 315 and 316 IPC),2014,0,0,0
Kerala,8 - Abetment of Suicide of child (Section 305 IPC),2014,4,0,4
Kerala,9 - Exposure and Abandonment (Section 317 IPC),2014,2,1,3
Kerala,10 - Procuration of minor girls (Section 366-A IPC),2014,4,0,4
Kerala,11 - Importation of Girls from Foreign Country (Section 366-B IPC),2014,0,0,0
Kerala,12 - Buying of minors for prostitution (Section 373 IPC),2014,0,0,0
Kerala,13 - Selling of minors for prostitution (Section 372 IPC),2014,0,0,0
Kerala,"14 - Prohibition of Child Marriage Act, 2006",2014,34,7,41
Kerala,"15 - Transplantation of Human Organs Act, 1994",2014,0,0,0
Kerala,"16 - Child Labour (Prohibition & Regulation) Act, 1986",2014,0,0,0
Kerala,16.1 - Offences committed against Migrant,2014,0,0,0
Kerala,16.1.1 - Offences committed against SC migrants,2014,0,0,0
Kerala,16.1.2 - Offences committed against ST migrants,2014,0,0,0
Kerala,16.1.3 - Offences committed against others migrants,2014,0,0,0
Kerala,16.2 - Offences committed against Locals,2014,0,0,0
Kerala,16.2.1 - Offences committed against Local SCs,2014,0,0,0
Kerala,16.2.2 - Offences committed against Local STs,2014,0,0,0
Kerala,16.2.3 - Offences committed against others locals,2014,0,0,0
Kerala,"17 - Immoral Traffic (Prevention) Act, 1956",2014,0,0,0
Kerala,17.1 - Under ITP Section 5,2014,0,0,0
Kerala,17.2 - Under ITP Section 6,2014,0,0,0
Kerala,17.3 - Under ITP Section 7,2014,0,0,0
Kerala,17.4 - Under ITP Section 8,2014,0,0,0
Kerala,17.5 - Other Section of ITP Act,2014,0,0,0
Kerala,"18 - Juvenile Justice (Care and Protection of Children) Act, 2000",2014,224,26,250
Kerala,"19 - Protection of Children from Sexual Offences Act, 2012",2014,433,0,433
Kerala,19.1 - Under PCSO Act Section 4,2014,102,0,102
Kerala,19.2 - Under PCSO Act Section 6,2014,4,0,4
Kerala,19.3 - Under PCSO Act Section 8,2014,163,0,163
Kerala,19.4 - Under PCSO Act Section 10,2014,28,0,28
Kerala,19.5 - Under PCSO Act Sections 14 & 15,2014,0,0,0
Kerala,19.6 - Other Acts of PCSO,2014,136,0,136
Kerala,20 - Attempt to commit Murder u/s 307 IPC,2014,23,1,24
Kerala,21 - Unnatural Offences u/s 377 IPC,2014,111,0,111
Kerala,22 - Other crimes committed against children,2014,575,12,587
Kerala,23 - Total crimes against Children,2014,2637,77,2714
Madhya Pradesh,1 - Murder (Section 302 and 303 IPC),2014,162,11,173
Madhya Pradesh,2 - Infanticide (Section 315 IPC),2014,3,0,3
Madhya Pradesh,3 - Rape,2014,2883,32,2915
Madhya Pradesh,4 - Assault on women with intent to outrage her Modesty (Section 354 IPC),2014,2750,5,2755
Madhya Pradesh,4.1 - Sexual Harassment (Section 354A IPC),2014,1007,1,1008
Madhya Pradesh,4.2 - Assault on women with intent to Disrobe (Section 354B IPC),2014,39,0,39
Madhya Pradesh,4.3 - Voyeurism (Section 354C IPC),2014,17,0,17
Madhya Pradesh,4.4 - Stalking (Section 354D IPC),2014,178,0,178
Madhya Pradesh,4.5 - Others assault,2014,1509,4,1513
Madhya Pradesh,5 - Insult to the Modesty of Women (Girls Children) (Section 509 IPC),2014,77,0,77
Madhya Pradesh,"6 - Kidnapping & Abduction_Total (Section 363,364,364A, 366-369 IPC)",2014,2654,47,2701
Madhya Pradesh,6.1 - Kidnapping & Abduction (Section 363 IPC),2014,876,15,891
Madhya Pradesh,6.2 - Kidnaping & Abduction in order to Murder (Section 364 IPC),2014,3,0,3
Madhya Pradesh,6.3 - Kidnapping for Ransom (Section 364A IPC),2014,13,1,14
Madhya Pradesh,6.4 - Kidnapping & Abduction of Women to compel her for marriage (Section 366 IPC),2014,1145,28,1173
Madhya Pradesh,6.5 - Other Kidnapping,2014,617,3,620
Madhya Pradesh,7 - Foeticide (Section 315 and 316 IPC),2014,6,2,8
Madhya Pradesh,8 - Abetment of Suicide of child (Section 305 IPC),2014,7,0,7
Madhya Pradesh,9 - Exposure and Abandonment (Section 317 IPC),2014,14,17,31
Madhya Pradesh,10 - Procuration of minor girls (Section 366-A IPC),2014,13,0,13
Madhya Pradesh,11 - Importation of Girls from Foreign Country (Section 366-B IPC),2014,0,0,0
Madhya Pradesh,12 - Buying of minors for prostitution (Section 373 IPC),2014,1,0,1
Madhya Pradesh,13 - Selling of minors for prostitution (Section 372 IPC),2014,4,0,4
Madhya Pradesh,"14 - Prohibition of Child Marriage Act, 2006",2014,47,11,58
Madhya Pradesh,"15 - Transplantation of Human Organs Act, 1994",2014,0,0,0
Madhya Pradesh,"16 - Child Labour (Prohibition & Regulation) Act, 1986",2014,4,0,4
Madhya Pradesh,16.1 - Offences committed against Migrant,2014,0,0,0
Madhya Pradesh,16.1.1 - Offences committed against SC migrants,2014,0,0,0
Madhya Pradesh,16.1.2 - Offences committed against ST migrants,2014,0,0,0
Madhya Pradesh,16.1.3 - Offences committed against others migrants,2014,0,0,0
Madhya Pradesh,16.2 - Offences committed against Locals,2014,4,0,4
Madhya Pradesh,16.2.1 - Offences committed against Local SCs,2014,2,0,2
Madhya Pradesh,16.2.2 - Offences committed against Local STs,2014,0,0,0
Madhya Pradesh,16.2.3 - Offences committed against others locals,2014,2,0,2
Madhya Pradesh,"17 - Immoral Traffic (Prevention) Act, 1956",2014,1,3,4
Madhya Pradesh,17.1 - Under ITP Section 5,2014,0,0,0
Madhya Pradesh,17.2 - Under ITP Section 6,2014,0,0,0
Madhya Pradesh,17.3 - Under ITP Section 7,2014,1,3,4
Madhya Pradesh,17.4 - Under ITP Section 8,2014,0,0,0
Madhya Pradesh,17.5 - Other Section of ITP Act,2014,0,0,0
Madhya Pradesh,"18 - Juvenile Justice (Care and Protection of Children) Act, 2000",2014,2,0,2
Madhya Pradesh,"19 - Protection of Children from Sexual Offences Act, 2012",2014,137,4,141
Madhya Pradesh,19.1 - Under PCSO Act Section 4,2014,42,3,45
Madhya Pradesh,19.2 - Under PCSO Act Section 6,2014,19,1,20
Madhya Pradesh,19.3 - Under PCSO Act Section 8,2014,48,0,48
Madhya Pradesh,19.4 - Under PCSO Act Section 10,2014,9,0,9
Madhya Pradesh,19.5 - Under PCSO Act Sections 14 & 15,2014,0,0,0
Madhya Pradesh,19.6 - Other Acts of PCSO,2014,19,0,19
Madhya Pradesh,20 - Attempt to commit Murder u/s 307 IPC,2014,46,0,46
Madhya Pradesh,21 - Unnatural Offences u/s 377 IPC,2014,97,0,97
Madhya Pradesh,22 - Other crimes committed against children,2014,4898,184,5082
Madhya Pradesh,23 - Total crimes against Children,2014,13806,316,14122
Maharashtra,1 - Murder (Section 302 and 303 IPC),2014,233,30,263
Maharashtra,2 - Infanticide (Section 315 IPC),2014,6,4,10
Maharashtra,3 - Rape,2014,1951,67,2018
Maharashtra,4 - Assault on women with intent to outrage her Modesty (Section 354 IPC),2014,2336,17,2353
Maharashtra,4.1 - Sexual Harassment (Section 354A IPC),2014,1046,7,1053
Maharashtra,4.2 - Assault on women with intent to Disrobe (Section 354B IPC),2014,61,0,61
Maharashtra,4.3 - Voyeurism (Section 354C IPC),2014,19,0,19
Maharashtra,4.4 - Stalking (Section 354D IPC),2014,293,0,293
Maharashtra,4.5 - Others assault,2014,917,10,927
Maharashtra,5 - Insult to the Modesty of Women (Girls Children) (Section 509 IPC),2014,78,0,78
Maharashtra,"6 - Kidnapping & Abduction_Total (Section 363,364,364A, 366-369 IPC)",2014,1528,114,1642
Maharashtra,6.1 - Kidnapping & Abduction (Section 363 IPC),2014,661,57,718
Maharashtra,6.2 - Kidnaping & Abduction in order to Murder (Section 364 IPC),2014,7,0,7
Maharashtra,6.3 - Kidnapping for Ransom (Section 364A IPC),2014,19,0,19
Maharashtra,6.4 - Kidnapping & Abduction of Women to compel her for marriage (Section 366 IPC),2014,647,44,691
Maharashtra,6.5 - Other Kidnapping,2014,194,13,207
Maharashtra,7 - Foeticide (Section 315 and 316 IPC),2014,4,1,5
Maharashtra,8 - Abetment of Suicide of child (Section 305 IPC),2014,18,2,20
Maharashtra,9 - Exposure and Abandonment (Section 317 IPC),2014,90,17,107
Maharashtra,10 - Procuration of minor girls (Section 366-A IPC),2014,7,0,7
Maharashtra,11 - Importation of Girls from Foreign Country (Section 366-B IPC),2014,0,0,0
Maharashtra,12 - Buying of minors for prostitution (Section 373 IPC),2014,9,0,9
Maharashtra,13 - Selling of minors for prostitution (Section 372 IPC),2014,4,0,4
Maharashtra,"14 - Prohibition of Child Marriage Act, 2006",2014,54,18,72
Maharashtra,"15 - Transplantation of Human Organs Act, 1994",2014,0,0,0
Maharashtra,"16 - Child Labour (Prohibition & Regulation) Act, 1986",2014,74,1,75
Maharashtra,16.1 - Offences committed against Migrant,2014,6,0,6
Maharashtra,16.1.1 - Offences committed against SC migrants,2014,0,0,0
Maharashtra,16.1.2 - Offences committed against ST migrants,2014,0,0,0
Maharashtra,16.1.3 - Offences committed against others migrants,2014,6,0,6
Maharashtra,16.2 - Offences committed against Locals,2014,68,1,69
Maharashtra,16.2.1 - Offences committed against Local SCs,2014,0,0,0
Maharashtra,16.2.2 - Offences committed against Local STs,2014,0,0,0
Maharashtra,16.2.3 - Offences committed against others locals,2014,68,1,69
Maharashtra,"17 - Immoral Traffic (Prevention) Act, 1956",2014,23,4,27
Maharashtra,17.1 - Under ITP Section 5,2014,7,1,8
Maharashtra,17.2 - Under ITP Section 6,2014,0,0,0
Maharashtra,17.3 - Under ITP Section 7,2014,13,0,13
Maharashtra,17.4 - Under ITP Section 8,2014,1,0,1
Maharashtra,17.5 - Other Section of ITP Act,2014,2,3,5
Maharashtra,"18 - Juvenile Justice (Care and Protection of Children) Act, 2000",2014,122,7,129
Maharashtra,"19 - Protection of Children from Sexual Offences Act, 2012",2014,173,1,174
Maharashtra,19.1 - Under PCSO Act Section 4,2014,80,1,81
Maharashtra,19.2 - Under PCSO Act Section 6,2014,34,0,34
Maharashtra,19.3 - Under PCSO Act Section 8,2014,27,0,27
Maharashtra,19.4 - Under PCSO Act Section 10,2014,2,0,2
Maharashtra,19.5 - Under PCSO Act Sections 14 & 15,2014,0,0,0
Maharashtra,19.6 - Other Acts of PCSO,2014,30,0,30
Maharashtra,20 - Attempt to commit Murder u/s 307 IPC,2014,88,7,95
Maharashtra,21 - Unnatural Offences u/s 377 IPC,2014,90,0,90
Maharashtra,22 - Other crimes committed against children,2014,1107,53,1160
Maharashtra,23 - Total crimes against Children,2014,7995,343,8338
Manipur,1 - Murder (Section 302 and 303 IPC),2014,3,0,3
Manipur,2 - Infanticide (Section 315 IPC),2014,0,0,0
Manipur,3 - Rape,2014,22,0,22
Manipur,4 - Assault on women with intent to outrage her Modesty (Section 354 IPC),2014,5,0,5
Manipur,4.1 - Sexual Harassment (Section 354A IPC),2014,1,0,1
Manipur,4.2 - Assault on women with intent to Disrobe (Section 354B IPC),2014,0,0,0
Manipur,4.3 - Voyeurism (Section 354C IPC),2014,0,0,0
Manipur,4.4 - Stalking (Section 354D IPC),2014,0,0,0
Manipur,4.5 - Others assault,2014,4,0,4
Manipur,5 - Insult to the Modesty of Women (Girls Children) (Section 509 IPC),2014,0,0,0
Manipur,"6 - Kidnapping & Abduction_Total (Section 363,364,364A, 366-369 IPC)",2014,15,0,15
Manipur,6.1 - Kidnapping & Abduction (Section 363 IPC),2014,1,0,1
Manipur,6.2 - Kidnaping & Abduction in order to Murder (Section 364 IPC),2014,0,0,0
Manipur,6.3 - Kidnapping for Ransom (Section 364A IPC),2014,0,0,0
Manipur,6.4 - Kidnapping & Abduction of Women to compel her for marriage (Section 366 IPC),2014,13,0,13
Manipur,6.5 - Other Kidnapping,2014,1,0,1
Manipur,7 - Foeticide (Section 315 and 316 IPC),2014,0,0,0
Manipur,8 - Abetment of Suicide of child (Section 305 IPC),2014,0,0,0
Manipur,9 - Exposure and Abandonment (Section 317 IPC),2014,0,0,0
Manipur,10 - Procuration of minor girls (Section 366-A IPC),2014,0,0,0
Manipur,11 - Importation of Girls from Foreign Country (Section 366-B IPC),2014,0,0,0
Manipur,12 - Buying of minors for prostitution (Section 373 IPC),2014,0,0,0
Manipur,13 - Selling of minors for prostitution (Section 372 IPC),2014,0,0,0
Manipur,"14 - Prohibition of Child Marriage Act, 2006",2014,0,0,0
Manipur,"15 - Transplantation of Human Organs Act, 1994",2014,0,0,0
Manipur,"16 - Child Labour (Prohibition & Regulation) Act, 1986",2014,0,0,0
Manipur,16.1 - Offences committed against Migrant,2014,0,0,0
Manipur,16.1.1 - Offences committed against SC migrants,2014,0,0,0
Manipur,16.1.2 - Offences committed against ST migrants,2014,0,0,0
Manipur,16.1.3 - Offences committed against others migrants,2014,0,0,0
Manipur,16.2 - Offences committed against Locals,2014,0,0,0
Manipur,16.2.1 - Offences committed against Local SCs,2014,0,0,0
Manipur,16.2.2 - Offences committed against Local STs,2014,0,0,0
Manipur,16.2.3 - Offences committed against others locals,2014,0,0,0
Manipur,"17 - Immoral Traffic (Prevention) Act, 1956",2014,0,0,0
Manipur,17.1 - Under ITP Section 5,2014,0,0,0
Manipur,17.2 - Under ITP Section 6,2014,0,0,0
Manipur,17.3 - Under ITP Section 7,2014,0,0,0
Manipur,17.4 - Under ITP Section 8,2014,0,0,0
Manipur,17.5 - Other Section of ITP Act,2014,0,0,0
Manipur,"18 - Juvenile Justice (Care and Protection of Children) Act, 2000",2014,1,0,1
Manipur,"19 - Protection of Children from Sexual Offences Act, 2012",2014,7,0,7
Manipur,19.1 - Under PCSO Act Section 4,2014,3,0,3
Manipur,19.2 - Under PCSO Act Section 6,2014,1,0,1
Manipur,19.3 - Under PCSO Act Section 8,2014,2,0,2
Manipur,19.4 - Under PCSO Act Section 10,2014,0,0,0
Manipur,19.5 - Under PCSO Act Sections 14 & 15,2014,0,0,0
Manipur,19.6 - Other Acts of PCSO,2014,1,0,1
Manipur,20 - Attempt to commit Murder u/s 307 IPC,2014,0,0,0
Manipur,21 - Unnatural Offences u/s 377 IPC,2014,0,0,0
Manipur,22 - Other crimes committed against children,2014,1,2,3
Manipur,23 - Total crimes against Children,2014,54,2,56
Meghalaya,1 - Murder (Section 302 and 303 IPC),2014,0,0,0
Meghalaya,2 - Infanticide (Section 315 IPC),2014,0,0,0
Meghalaya,3 - Rape,2014,69,0,69
Meghalaya,4 - Assault on women with intent to outrage her Modesty (Section 354 IPC),2014,7,0,7
Meghalaya,4.1 - Sexual Harassment (Section 354A IPC),2014,0,0,0
Meghalaya,4.2 - Assault on women with intent to Disrobe (Section 354B IPC),2014,0,0,0
Meghalaya,4.3 - Voyeurism (Section 354C IPC),2014,0,0,0
Meghalaya,4.4 - Stalking (Section 354D IPC),2014,0,0,0
Meghalaya,4.5 - Others assault,2014,7,0,7
Meghalaya,5 - Insult to the Modesty of Women (Girls Children) (Section 509 IPC),2014,2,0,2
Meghalaya,"6 - Kidnapping & Abduction_Total (Section 363,364,364A, 366-369 IPC)",2014,22,0,22
Meghalaya,6.1 - Kidnapping & Abduction (Section 363 IPC),2014,10,0,10
Meghalaya,6.2 - Kidnaping & Abduction in order to Murder (Section 364 IPC),2014,0,0,0
Meghalaya,6.3 - Kidnapping for Ransom (Section 364A IPC),2014,3,0,3
Meghalaya,6.4 - Kidnapping & Abduction of Women to compel her for marriage (Section 366 IPC),2014,0,0,0
Meghalaya,6.5 - Other Kidnapping,2014,9,0,9
Meghalaya,7 - Foeticide (Section 315 and 316 IPC),2014,0,0,0
Meghalaya,8 - Abetment of Suicide of child (Section 305 IPC),2014,0,0,0
Meghalaya,9 - Exposure and Abandonment (Section 317 IPC),2014,0,0,0
Meghalaya,10 - Procuration of minor girls (Section 366-A IPC),2014,12,0,12
Meghalaya,11 - Importation of Girls from Foreign Country (Section 366-B IPC),2014,0,0,0
Meghalaya,12 - Buying of minors for prostitution (Section 373 IPC),2014,0,0,0
Meghalaya,13 - Selling of minors for prostitution (Section 372 IPC),2014,0,0,0
Meghalaya,"14 - Prohibition of Child Marriage Act, 2006",2014,0,0,0
Meghalaya,"15 - Transplantation of Human Organs Act, 1994",2014,0,0,0
Meghalaya,"16 - Child Labour (Prohibition & Regulation) Act, 1986",2014,0,0,0
Meghalaya,16.1 - Offences committed against Migrant,2014,0,0,0
Meghalaya,16.1.1 - Offences committed against SC migrants,2014,0,0,0
Meghalaya,16.1.2 - Offences committed against ST migrants,2014,0,0,0
Meghalaya,16.1.3 - Offences committed against others migrants,2014,0,0,0
Meghalaya,16.2 - Offences committed against Locals,2014,0,0,0
Meghalaya,16.2.1 - Offences committed against Local SCs,2014,0,0,0
Meghalaya,16.2.2 - Offences committed against Local STs,2014,0,0,0
Meghalaya,16.2.3 - Offences committed against others locals,2014,0,0,0
Meghalaya,"17 - Immoral Traffic (Prevention) Act, 1956",2014,0,0,0
Meghalaya,17.1 - Under ITP Section 5,2014,0,0,0
Meghalaya,17.2 - Under ITP Section 6,2014,0,0,0
Meghalaya,17.3 - Under ITP Section 7,2014,0,0,0
Meghalaya,17.4 - Under ITP Section 8,2014,0,0,0
Meghalaya,17.5 - Other Section of ITP Act,2014,0,0,0
Meghalaya,"18 - Juvenile Justice (Care and Protection of Children) Act, 2000",2014,0,0,0
Meghalaya,"19 - Protection of Children from Sexual Offences Act, 2012",2014,44,0,44
Meghalaya,19.1 - Under PCSO Act Section 4,2014,26,0,26
Meghalaya,19.2 - Under PCSO Act Section 6,2014,6,0,6
Meghalaya,19.3 - Under PCSO Act Section 8,2014,4,0,4
Meghalaya,19.4 - Under PCSO Act Section 10,2014,3,0,3
Meghalaya,19.5 - Under PCSO Act Sections 14 & 15,2014,0,0,0
Meghalaya,19.6 - Other Acts of PCSO,2014,5,0,5
Meghalaya,20 - Attempt to commit Murder u/s 307 IPC,2014,18,0,18
Meghalaya,21 - Unnatural Offences u/s 377 IPC,2014,0,0,0
Meghalaya,22 - Other crimes committed against children,2014,9,0,9
Meghalaya,23 - Total crimes against Children,2014,183,0,183
Mizoram,1 - Murder (Section 302 and 303 IPC),2014,0,0,0
Mizoram,2 - Infanticide (Section 315 IPC),2014,0,0,0
Mizoram,3 - Rape,2014,90,0,90
Mizoram,4 - Assault on women with intent to outrage her Modesty (Section 354 IPC),2014,33,0,33
Mizoram,4.1 - Sexual Harassment (Section 354A IPC),2014,19,0,19
Mizoram,4.2 - Assault on women with intent to Disrobe (Section 354B IPC),2014,7,0,7
Mizoram,4.3 - Voyeurism (Section 354C IPC),2014,0,0,0
Mizoram,4.4 - Stalking (Section 354D IPC),2014,1,0,1
Mizoram,4.5 - Others assault,2014,6,0,6
Mizoram,5 - Insult to the Modesty of Women (Girls Children) (Section 509 IPC),2014,0,0,0
Mizoram,"6 - Kidnapping & Abduction_Total (Section 363,364,364A, 366-369 IPC)",2014,1,1,2
Mizoram,6.1 - Kidnapping & Abduction (Section 363 IPC),2014,1,0,1
Mizoram,6.2 - Kidnaping & Abduction in order to Murder (Section 364 IPC),2014,0,0,0
Mizoram,6.3 - Kidnapping for Ransom (Section 364A IPC),2014,0,0,0
Mizoram,6.4 - Kidnapping & Abduction of Women to compel her for marriage (Section 366 IPC),2014,0,0,0
Mizoram,6.5 - Other Kidnapping,2014,0,1,1
Mizoram,7 - Foeticide (Section 315 and 316 IPC),2014,0,0,0
Mizoram,8 - Abetment of Suicide of child (Section 305 IPC),2014,0,0,0
Mizoram,9 - Exposure and Abandonment (Section 317 IPC),2014,0,0,0
Mizoram,10 - Procuration of minor girls (Section 366-A IPC),2014,0,0,0
Mizoram,11 - Importation of Girls from Foreign Country (Section 366-B IPC),2014,0,0,0
Mizoram,12 - Buying of minors for prostitution (Section 373 IPC),2014,0,0,0
Mizoram,13 - Selling of minors for prostitution (Section 372 IPC),2014,0,0,0
Mizoram,"14 - Prohibition of Child Marriage Act, 2006",2014,0,0,0
Mizoram,"15 - Transplantation of Human Organs Act, 1994",2014,0,0,0
Mizoram,"16 - Child Labour (Prohibition & Regulation) Act, 1986",2014,0,0,0
Mizoram,16.1 - Offences committed against Migrant,2014,0,0,0
Mizoram,16.1.1 - Offences committed against SC migrants,2014,0,0,0
Mizoram,16.1.2 - Offences committed against ST migrants,2014,0,0,0
Mizoram,16.1.3 - Offences committed against others migrants,2014,0,0,0
Mizoram,16.2 - Offences committed against Locals,2014,0,0,0
Mizoram,16.2.1 - Offences committed against Local SCs,2014,0,0,0
Mizoram,16.2.2 - Offences committed against Local STs,2014,0,0,0
Mizoram,16.2.3 - Offences committed against others locals,2014,0,0,0
Mizoram,"17 - Immoral Traffic (Prevention) Act, 1956",2014,0,0,0
Mizoram,17.1 - Under ITP Section 5,2014,0,0,0
Mizoram,17.2 - Under ITP Section 6,2014,0,0,0
Mizoram,17.3 - Under ITP Section 7,2014,0,0,0
Mizoram,17.4 - Under ITP Section 8,2014,0,0,0
Mizoram,17.5 - Other Section of ITP Act,2014,0,0,0
Mizoram,"18 - Juvenile Justice (Care and Protection of Children) Act, 2000",2014,0,0,0
Mizoram,"19 - Protection of Children from Sexual Offences Act, 2012",2014,17,0,17
Mizoram,19.1 - Under PCSO Act Section 4,2014,9,0,9
Mizoram,19.2 - Under PCSO Act Section 6,2014,4,0,4
Mizoram,19.3 - Under PCSO Act Section 8,2014,4,0,4
Mizoram,19.4 - Under PCSO Act Section 10,2014,0,0,0
Mizoram,19.5 - Under PCSO Act Sections 14 & 15,2014,0,0,0
Mizoram,19.6 - Other Acts of PCSO,2014,0,0,0
Mizoram,20 - Attempt to commit Murder u/s 307 IPC,2014,0,0,0
Mizoram,21 - Unnatural Offences u/s 377 IPC,2014,4,0,4
Mizoram,22 - Other crimes committed against children,2014,7,0,7
Mizoram,23 - Total crimes against Children,2014,152,1,153
Nagaland,1 - Murder (Section 302 and 303 IPC),2014,0,1,1
Nagaland,2 - Infanticide (Section 315 IPC),2014,0,0,0
Nagaland,3 - Rape,2014,9,0,9
Nagaland,4 - Assault on women with intent to outrage her Modesty (Section 354 IPC),2014,6,0,6
Nagaland,4.1 - Sexual Harassment (Section 354A IPC),2014,1,0,1
Nagaland,4.2 - Assault on women with intent to Disrobe (Section 354B IPC),2014,0,0,0
Nagaland,4.3 - Voyeurism (Section 354C IPC),2014,0,0,0
Nagaland,4.4 - Stalking (Section 354D IPC),2014,0,0,0
Nagaland,4.5 - Others assault,2014,5,0,5
Nagaland,5 - Insult to the Modesty of Women (Girls Children) (Section 509 IPC),2014,0,0,0
Nagaland,"6 - Kidnapping & Abduction_Total (Section 363,364,364A, 366-369 IPC)",2014,7,0,7
Nagaland,6.1 - Kidnapping & Abduction (Section 363 IPC),2014,4,0,4
Nagaland,6.2 - Kidnaping & Abduction in order to Murder (Section 364 IPC),2014,0,0,0
Nagaland,6.3 - Kidnapping for Ransom (Section 364A IPC),2014,0,0,0
Nagaland,6.4 - Kidnapping & Abduction of Women to compel her for marriage (Section 366 IPC),2014,2,0,2
Nagaland,6.5 - Other Kidnapping,2014,1,0,1
Nagaland,7 - Foeticide (Section 315 and 316 IPC),2014,0,0,0
Nagaland,8 - Abetment of Suicide of child (Section 305 IPC),2014,0,0,0
Nagaland,9 - Exposure and Abandonment (Section 317 IPC),2014,0,0,0
Nagaland,10 - Procuration of minor girls (Section 366-A IPC),2014,0,0,0
Nagaland,11 - Importation of Girls from Foreign Country (Section 366-B IPC),2014,0,0,0
Nagaland,12 - Buying of minors for prostitution (Section 373 IPC),2014,0,0,0
Nagaland,13 - Selling of minors for prostitution (Section 372 IPC),2014,0,0,0
Nagaland,"14 - Prohibition of Child Marriage Act, 2006",2014,0,0,0
Nagaland,"15 - Transplantation of Human Organs Act, 1994",2014,0,0,0
Nagaland,"16 - Child Labour (Prohibition & Regulation) Act, 1986",2014,0,0,0
Nagaland,16.1 - Offences committed against Migrant,2014,0,0,0
Nagaland,16.1.1 - Offences committed against SC migrants,2014,0,0,0
Nagaland,16.1.2 - Offences committed against ST migrants,2014,0,0,0
Nagaland,16.1.3 - Offences committed against others migrants,2014,0,0,0
Nagaland,16.2 - Offences committed against Locals,2014,0,0,0
Nagaland,16.2.1 - Offences committed against Local SCs,2014,0,0,0
Nagaland,16.2.2 - Offences committed against Local STs,2014,0,0,0
Nagaland,16.2.3 - Offences committed against others locals,2014,0,0,0
Nagaland,"17 - Immoral Traffic (Prevention) Act, 1956",2014,0,0,0
Nagaland,17.1 - Under ITP Section 5,2014,0,0,0
Nagaland,17.2 - Under ITP Section 6,2014,0,0,0
Nagaland,17.3 - Under ITP Section 7,2014,0,0,0
Nagaland,17.4 - Under ITP Section 8,2014,0,0,0
Nagaland,17.5 - Other Section of ITP Act,2014,0,0,0
Nagaland,"18 - Juvenile Justice (Care and Protection of Children) Act, 2000",2014,0,0,0
Nagaland,"19 - Protection of Children from Sexual Offences Act, 2012",2014,0,0,0
Nagaland,19.1 - Under PCSO Act Section 4,2014,0,0,0
Nagaland,19.2 - Under PCSO Act Section 6,2014,0,0,0
Nagaland,19.3 - Under PCSO Act Section 8,2014,0,0,0
Nagaland,19.4 - Under PCSO Act Section 10,2014,0,0,0
Nagaland,19.5 - Under PCSO Act Sections 14 & 15,2014,0,0,0
Nagaland,19.6 - Other Acts of PCSO,2014,0,0,0
Nagaland,20 - Attempt to commit Murder u/s 307 IPC,2014,22,0,22
Nagaland,21 - Unnatural Offences u/s 377 IPC,2014,0,0,0
Nagaland,22 - Other crimes committed against children,2014,0,0,0
Nagaland,23 - Total crimes against Children,2014,44,1,45
Odisha,1 - Murder (Section 302 and 303 IPC),2014,24,2,26
Odisha,2 - Infanticide (Section 315 IPC),2014,0,0,0
Odisha,3 - Rape,2014,712,3,715
Odisha,4 - Assault on women with intent to outrage her Modesty (Section 354 IPC),2014,307,32,339
Odisha,4.1 - Sexual Harassment (Section 354A IPC),2014,141,32,173
Odisha,4.2 - Assault on women with intent to Disrobe (Section 354B IPC),2014,21,0,21
Odisha,4.3 - Voyeurism (Section 354C IPC),2014,0,0,0
Odisha,4.4 - Stalking (Section 354D IPC),2014,0,0,0
Odisha,4.5 - Others assault,2014,145,0,145
Odisha,5 - Insult to the Modesty of Women (Girls Children) (Section 509 IPC),2014,39,0,39
Odisha,"6 - Kidnapping & Abduction_Total (Section 363,364,364A, 366-369 IPC)",2014,389,3,392
Odisha,6.1 - Kidnapping & Abduction (Section 363 IPC),2014,180,0,180
Odisha,6.2 - Kidnaping & Abduction in order to Murder (Section 364 IPC),2014,3,0,3
Odisha,6.3 - Kidnapping for Ransom (Section 364A IPC),2014,1,0,1
Odisha,6.4 - Kidnapping & Abduction of Women to compel her for marriage (Section 366 IPC),2014,142,3,145
Odisha,6.5 - Other Kidnapping,2014,63,0,63
Odisha,7 - Foeticide (Section 315 and 316 IPC),2014,0,0,0
Odisha,8 - Abetment of Suicide of child (Section 305 IPC),2014,0,0,0
Odisha,9 - Exposure and Abandonment (Section 317 IPC),2014,0,0,0
Odisha,10 - Procuration of minor girls (Section 366-A IPC),2014,30,2,32
Odisha,11 - Importation of Girls from Foreign Country (Section 366-B IPC),2014,0,0,0
Odisha,12 - Buying of minors for prostitution (Section 373 IPC),2014,0,0,0
Odisha,13 - Selling of minors for prostitution (Section 372 IPC),2014,0,0,0
Odisha,"14 - Prohibition of Child Marriage Act, 2006",2014,0,0,0
Odisha,"15 - Transplantation of Human Organs Act, 1994",2014,0,0,0
Odisha,"16 - Child Labour (Prohibition & Regulation) Act, 1986",2014,3,1,4
Odisha,16.1 - Offences committed against Migrant,2014,0,0,0
Odisha,16.1.1 - Offences committed against SC migrants,2014,0,0,0
Odisha,16.1.2 - Offences committed against ST migrants,2014,0,0,0
Odisha,16.1.3 - Offences committed against others migrants,2014,0,0,0
Odisha,16.2 - Offences committed against Locals,2014,3,1,4
Odisha,16.2.1 - Offences committed against Local SCs,2014,0,0,0
Odisha,16.2.2 - Offences committed against Local STs,2014,0,0,0
Odisha,16.2.3 - Offences committed against others locals,2014,3,1,4
Odisha,"17 - Immoral Traffic (Prevention) Act, 1956",2014,1,0,1
Odisha,17.1 - Under ITP Section 5,2014,0,0,0
Odisha,17.2 - Under ITP Section 6,2014,1,0,1
Odisha,17.3 - Under ITP Section 7,2014,0,0,0
Odisha,17.4 - Under ITP Section 8,2014,0,0,0
Odisha,17.5 - Other Section of ITP Act,2014,0,0,0
Odisha,"18 - Juvenile Justice (Care and Protection of Children) Act, 2000",2014,16,0,16
Odisha,"19 - Protection of Children from Sexual Offences Act, 2012",2014,100,0,100
Odisha,19.1 - Under PCSO Act Section 4,2014,53,0,53
Odisha,19.2 - Under PCSO Act Section 6,2014,33,0,33
Odisha,19.3 - Under PCSO Act Section 8,2014,7,0,7
Odisha,19.4 - Under PCSO Act Section 10,2014,2,0,2
Odisha,19.5 - Under PCSO Act Sections 14 & 15,2014,0,0,0
Odisha,19.6 - Other Acts of PCSO,2014,5,0,5
Odisha,20 - Attempt to commit Murder u/s 307 IPC,2014,4,0,4
Odisha,21 - Unnatural Offences u/s 377 IPC,2014,5,0,5
Odisha,22 - Other crimes committed against children,2014,172,5,177
Odisha,23 - Total crimes against Children,2014,1802,48,1850
Punjab,1 - Murder (Section 302 and 303 IPC),2014,57,4,61
Punjab,2 - Infanticide (Section 315 IPC),2014,4,1,5
Punjab,3 - Rape,2014,542,11,553
Punjab,4 - Assault on women with intent to outrage her Modesty (Section 354 IPC),2014,177,1,178
Punjab,4.1 - Sexual Harassment (Section 354A IPC),2014,69,0,69
Punjab,4.2 - Assault on women with intent to Disrobe (Section 354B IPC),2014,7,0,7
Punjab,4.3 - Voyeurism (Section 354C IPC),2014,2,0,2
Punjab,4.4 - Stalking (Section 354D IPC),2014,12,0,12
Punjab,4.5 - Others assault,2014,87,1,88
Punjab,5 - Insult to the Modesty of Women (Girls Children) (Section 509 IPC),2014,0,0,0
Punjab,"6 - Kidnapping & Abduction_Total (Section 363,364,364A, 366-369 IPC)",2014,631,27,658
Punjab,6.1 - Kidnapping & Abduction (Section 363 IPC),2014,83,8,91
Punjab,6.2 - Kidnaping & Abduction in order to Murder (Section 364 IPC),2014,18,0,18
Punjab,6.3 - Kidnapping for Ransom (Section 364A IPC),2014,6,0,6
Punjab,6.4 - Kidnapping & Abduction of Women to compel her for marriage (Section 366 IPC),2014,335,14,349
Punjab,6.5 - Other Kidnapping,2014,189,5,194
Punjab,7 - Foeticide (Section 315 and 316 IPC),2014,2,0,2
Punjab,8 - Abetment of Suicide of child (Section 305 IPC),2014,0,0,0
Punjab,9 - Exposure and Abandonment (Section 317 IPC),2014,4,0,4
Punjab,10 - Procuration of minor girls (Section 366-A IPC),2014,3,1,4
Punjab,11 - Importation of Girls from Foreign Country (Section 366-B IPC),2014,0,0,0
Punjab,12 - Buying of minors for prostitution (Section 373 IPC),2014,0,0,0
Punjab,13 - Selling of minors for prostitution (Section 372 IPC),2014,0,0,0
Punjab,"14 - Prohibition of Child Marriage Act, 2006",2014,1,2,3
Punjab,"15 - Transplantation of Human Organs Act, 1994",2014,0,0,0
Punjab,"16 - Child Labour (Prohibition & Regulation) Act, 1986",2014,0,0,0
Punjab,16.1 - Offences committed against Migrant,2014,0,0,0
Punjab,16.1.1 - Offences committed against SC migrants,2014,0,0,0
Punjab,16.1.2 - Offences committed against ST migrants,2014,0,0,0
Punjab,16.1.3 - Offences committed against others migrants,2014,0,0,0
Punjab,16.2 - Offences committed against Locals,2014,0,0,0
Punjab,16.2.1 - Offences committed against Local SCs,2014,0,0,0
Punjab,16.2.2 - Offences committed against Local STs,2014,0,0,0
Punjab,16.2.3 - Offences committed against others locals,2014,0,0,0
Punjab,"17 - Immoral Traffic (Prevention) Act, 1956",2014,0,0,0
Punjab,17.1 - Under ITP Section 5,2014,0,0,0
Punjab,17.2 - Under ITP Section 6,2014,0,0,0
Punjab,17.3 - Under ITP Section 7,2014,0,0,0
Punjab,17.4 - Under ITP Section 8,2014,0,0,0
Punjab,17.5 - Other Section of ITP Act,2014,0,0,0
Punjab,"18 - Juvenile Justice (Care and Protection of Children) Act, 2000",2014,0,0,0
Punjab,"19 - Protection of Children from Sexual Offences Act, 2012",2014,32,0,32
Punjab,19.1 - Under PCSO Act Section 4,2014,10,0,10
Punjab,19.2 - Under PCSO Act Section 6,2014,0,0,0
Punjab,19.3 - Under PCSO Act Section 8,2014,2,0,2
Punjab,19.4 - Under PCSO Act Section 10,2014,11,0,11
Punjab,19.5 - Under PCSO Act Sections 14 & 15,2014,0,0,0
Punjab,19.6 - Other Acts of PCSO,2014,9,0,9
Punjab,20 - Attempt to commit Murder u/s 307 IPC,2014,58,5,63
Punjab,21 - Unnatural Offences u/s 377 IPC,2014,56,3,59
Punjab,22 - Other crimes committed against children,2014,57,4,61
Punjab,23 - Total crimes against Children,2014,1624,59,1683
Rajasthan,1 - Murder (Section 302 and 303 IPC),2014,75,5,80
Rajasthan,2 - Infanticide (Section 315 IPC),2014,9,0,9
Rajasthan,3 - Rape,2014,761,14,775
Rajasthan,4 - Assault on women with intent to outrage her Modesty (Section 354 IPC),2014,270,5,275
Rajasthan,4.1 - Sexual Harassment (Section 354A IPC),2014,47,0,47
Rajasthan,4.2 - Assault on women with intent to Disrobe (Section 354B IPC),2014,12,0,12
Rajasthan,4.3 - Voyeurism (Section 354C IPC),2014,2,0,2
Rajasthan,4.4 - Stalking (Section 354D IPC),2014,20,0,20
Rajasthan,4.5 - Others assault,2014,189,5,194
Rajasthan,5 - Insult to the Modesty of Women (Girls Children) (Section 509 IPC),2014,1,0,1
Rajasthan,"6 - Kidnapping & Abduction_Total (Section 363,364,364A, 366-369 IPC)",2014,845,21,866
Rajasthan,6.1 - Kidnapping & Abduction (Section 363 IPC),2014,249,8,257
Rajasthan,6.2 - Kidnaping & Abduction in order to Murder (Section 364 IPC),2014,9,0,9
Rajasthan,6.3 - Kidnapping for Ransom (Section 364A IPC),2014,18,2,20
Rajasthan,6.4 - Kidnapping & Abduction of Women to compel her for marriage (Section 366 IPC),2014,335,8,343
Rajasthan,6.5 - Other Kidnapping,2014,234,3,237
Rajasthan,7 - Foeticide (Section 315 and 316 IPC),2014,1,3,4
Rajasthan,8 - Abetment of Suicide of child (Section 305 IPC),2014,0,0,0
Rajasthan,9 - Exposure and Abandonment (Section 317 IPC),2014,9,12,21
Rajasthan,10 - Procuration of minor girls (Section 366-A IPC),2014,36,0,36
Rajasthan,11 - Importation of Girls from Foreign Country (Section 366-B IPC),2014,0,0,0
Rajasthan,12 - Buying of minors for prostitution (Section 373 IPC),2014,0,0,0
Rajasthan,13 - Selling of minors for prostitution (Section 372 IPC),2014,0,0,0
Rajasthan,"14 - Prohibition of Child Marriage Act, 2006",2014,18,2,20
Rajasthan,"15 - Transplantation of Human Organs Act, 1994",2014,0,0,0
Rajasthan,"16 - Child Labour (Prohibition & Regulation) Act, 1986",2014,5,0,5
Rajasthan,16.1 - Offences committed against Migrant,2014,1,0,1
Rajasthan,16.1.1 - Offences committed against SC migrants,2014,0,0,0
Rajasthan,16.1.2 - Offences committed against ST migrants,2014,0,0,0
Rajasthan,16.1.3 - Offences committed against others migrants,2014,1,0,1
Rajasthan,16.2 - Offences committed against Locals,2014,4,0,4
Rajasthan,16.2.1 - Offences committed against Local SCs,2014,0,0,0
Rajasthan,16.2.2 - Offences committed against Local STs,2014,0,0,0
Rajasthan,16.2.3 - Offences committed against others locals,2014,4,0,4
Rajasthan,"17 - Immoral Traffic (Prevention) Act, 1956",2014,0,0,0
Rajasthan,17.1 - Under ITP Section 5,2014,0,0,0
Rajasthan,17.2 - Under ITP Section 6,2014,0,0,0
Rajasthan,17.3 - Under ITP Section 7,2014,0,0,0
Rajasthan,17.4 - Under ITP Section 8,2014,0,0,0
Rajasthan,17.5 - Other Section of ITP Act,2014,0,0,0
Rajasthan,"18 - Juvenile Justice (Care and Protection of Children) Act, 2000",2014,151,0,151
Rajasthan,"19 - Protection of Children from Sexual Offences Act, 2012",2014,176,1,177
Rajasthan,19.1 - Under PCSO Act Section 4,2014,49,0,49
Rajasthan,19.2 - Under PCSO Act Section 6,2014,18,1,19
Rajasthan,19.3 - Under PCSO Act Section 8,2014,18,0,18
Rajasthan,19.4 - Under PCSO Act Section 10,2014,2,0,2
Rajasthan,19.5 - Under PCSO Act Sections 14 & 15,2014,0,0,0
Rajasthan,19.6 - Other Acts of PCSO,2014,89,0,89
Rajasthan,20 - Attempt to commit Murder u/s 307 IPC,2014,82,16,98
Rajasthan,21 - Unnatural Offences u/s 377 IPC,2014,8,0,8
Rajasthan,22 - Other crimes committed against children,2014,131,3,134
Rajasthan,23 - Total crimes against Children,2014,2578,82,2660
Sikkim,1 - Murder (Section 302 and 303 IPC),2014,1,0,1
Sikkim,2 - Infanticide (Section 315 IPC),2014,0,0,0
Sikkim,3 - Rape,2014,36,0,36
Sikkim,4 - Assault on women with intent to outrage her Modesty (Section 354 IPC),2014,7,0,7
Sikkim,4.1 - Sexual Harassment (Section 354A IPC),2014,4,0,4
Sikkim,4.2 - Assault on women with intent to Disrobe (Section 354B IPC),2014,0,0,0
Sikkim,4.3 - Voyeurism (Section 354C IPC),2014,0,0,0
Sikkim,4.4 - Stalking (Section 354D IPC),2014,0,0,0
Sikkim,4.5 - Others assault,2014,3,0,3
Sikkim,5 - Insult to the Modesty of Women (Girls Children) (Section 509 IPC),2014,0,0,0
Sikkim,"6 - Kidnapping & Abduction_Total (Section 363,364,364A, 366-369 IPC)",2014,6,0,6
Sikkim,6.1 - Kidnapping & Abduction (Section 363 IPC),2014,5,0,5
Sikkim,6.2 - Kidnaping & Abduction in order to Murder (Section 364 IPC),2014,0,0,0
Sikkim,6.3 - Kidnapping for Ransom (Section 364A IPC),2014,0,0,0
Sikkim,6.4 - Kidnapping & Abduction of Women to compel her for marriage (Section 366 IPC),2014,0,0,0
Sikkim,6.5 - Other Kidnapping,2014,1,0,1
Sikkim,7 - Foeticide (Section 315 and 316 IPC),2014,0,0,0
Sikkim,8 - Abetment of Suicide of child (Section 305 IPC),2014,0,0,0
Sikkim,9 - Exposure and Abandonment (Section 317 IPC),2014,0,0,0
Sikkim,10 - Procuration of minor girls (Section 366-A IPC),2014,0,0,0
Sikkim,11 - Importation of Girls from Foreign Country (Section 366-B IPC),2014,0,0,0
Sikkim,12 - Buying of minors for prostitution (Section 373 IPC),2014,0,0,0
Sikkim,13 - Selling of minors for prostitution (Section 372 IPC),2014,0,0,0
Sikkim,"14 - Prohibition of Child Marriage Act, 2006",2014,0,0,0
Sikkim,"15 - Transplantation of Human Organs Act, 1994",2014,0,0,0
Sikkim,"16 - Child Labour (Prohibition & Regulation) Act, 1986",2014,0,0,0
Sikkim,16.1 - Offences committed against Migrant,2014,0,0,0
Sikkim,16.1.1 - Offences committed against SC migrants,2014,0,0,0
Sikkim,16.1.2 - Offences committed against ST migrants,2014,0,0,0
Sikkim,16.1.3 - Offences committed against others migrants,2014,0,0,0
Sikkim,16.2 - Offences committed against Locals,2014,0,0,0
Sikkim,16.2.1 - Offences committed against Local SCs,2014,0,0,0
Sikkim,16.2.2 - Offences committed against Local STs,2014,0,0,0
Sikkim,16.2.3 - Offences committed against others locals,2014,0,0,0
Sikkim,"17 - Immoral Traffic (Prevention) Act, 1956",2014,0,0,0
Sikkim,17.1 - Under ITP Section 5,2014,0,0,0
Sikkim,17.2 - Under ITP Section 6,2014,0,0,0
Sikkim,17.3 - Under ITP Section 7,2014,0,0,0
Sikkim,17.4 - Under ITP Section 8,2014,0,0,0
Sikkim,17.5 - Other Section of ITP Act,2014,0,0,0
Sikkim,"18 - Juvenile Justice (Care and Protection of Children) Act, 2000",2014,0,0,0
Sikkim,"19 - Protection of Children from Sexual Offences Act, 2012",2014,23,0,23
Sikkim,19.1 - Under PCSO Act Section 4,2014,6,0,6
Sikkim,19.2 - Under PCSO Act Section 6,2014,1,0,1
Sikkim,19.3 - Under PCSO Act Section 8,2014,13,0,13
Sikkim,19.4 - Under PCSO Act Section 10,2014,1,0,1
Sikkim,19.5 - Under PCSO Act Sections 14 & 15,2014,0,0,0
Sikkim,19.6 - Other Acts of PCSO,2014,2,0,2
Sikkim,20 - Attempt to commit Murder u/s 307 IPC,2014,9,0,9
Sikkim,21 - Unnatural Offences u/s 377 IPC,2014,1,0,1
Sikkim,22 - Other crimes committed against children,2014,0,0,0
Sikkim,23 - Total crimes against Children,2014,83,0,83
Tamil Nadu,1 - Murder (Section 302 and 303 IPC),2014,117,12,129
Tamil Nadu,2 - Infanticide (Section 315 IPC),2014,0,0,0
Tamil Nadu,3 - Rape,2014,6,0,6
Tamil Nadu,4 - Assault on women with intent to outrage her Modesty (Section 354 IPC),2014,3,0,3
Tamil Nadu,4.1 - Sexual Harassment (Section 354A IPC),2014,0,0,0
Tamil Nadu,4.2 - Assault on women with intent to Disrobe (Section 354B IPC),2014,0,0,0
Tamil Nadu,4.3 - Voyeurism (Section 354C IPC),2014,0,0,0
Tamil Nadu,4.4 - Stalking (Section 354D IPC),2014,0,0,0
Tamil Nadu,4.5 - Others assault,2014,3,0,3
Tamil Nadu,5 - Insult to the Modesty of Women (Girls Children) (Section 509 IPC),2014,8,0,8
Tamil Nadu,"6 - Kidnapping & Abduction_Total (Section 363,364,364A, 366-369 IPC)",2014,423,14,437
Tamil Nadu,6.1 - Kidnapping & Abduction (Section 363 IPC),2014,29,2,31
Tamil Nadu,6.2 - Kidnaping & Abduction in order to Murder (Section 364 IPC),2014,0,0,0
Tamil Nadu,6.3 - Kidnapping for Ransom (Section 364A IPC),2014,0,0,0
Tamil Nadu,6.4 - Kidnapping & Abduction of Women to compel her for marriage (Section 366 IPC),2014,373,11,384
Tamil Nadu,6.5 - Other Kidnapping,2014,21,1,22
Tamil Nadu,7 - Foeticide (Section 315 and 316 IPC),2014,0,0,0
Tamil Nadu,8 - Abetment of Suicide of child (Section 305 IPC),2014,1,0,1
Tamil Nadu,9 - Exposure and Abandonment (Section 317 IPC),2014,1,0,1
Tamil Nadu,10 - Procuration of minor girls (Section 366-A IPC),2014,0,0,0
Tamil Nadu,11 - Importation of Girls from Foreign Country (Section 366-B IPC),2014,0,0,0
Tamil Nadu,12 - Buying of minors for prostitution (Section 373 IPC),2014,0,0,0
Tamil Nadu,13 - Selling of minors for prostitution (Section 372 IPC),2014,0,0,0
Tamil Nadu,"14 - Prohibition of Child Marriage Act, 2006",2014,93,40,133
Tamil Nadu,"15 - Transplantation of Human Organs Act, 1994",2014,0,0,0
Tamil Nadu,"16 - Child Labour (Prohibition & Regulation) Act, 1986",2014,0,0,0
Tamil Nadu,16.1 - Offences committed against Migrant,2014,0,0,0
Tamil Nadu,16.1.1 - Offences committed against SC migrants,2014,0,0,0
Tamil Nadu,16.1.2 - Offences committed against ST migrants,2014,0,0,0
Tamil Nadu,16.1.3 - Offences committed against others migrants,2014,0,0,0
Tamil Nadu,16.2 - Offences committed against Locals,2014,0,0,0
Tamil Nadu,16.2.1 - Offences committed against Local SCs,2014,0,0,0
Tamil Nadu,16.2.2 - Offences committed against Local STs,2014,0,0,0
Tamil Nadu,16.2.3 - Offences committed against others locals,2014,0,0,0
Tamil Nadu,"17 - Immoral Traffic (Prevention) Act, 1956",2014,2,1,3
Tamil Nadu,17.1 - Under ITP Section 5,2014,0,0,0
Tamil Nadu,17.2 - Under ITP Section 6,2014,0,0,0
Tamil Nadu,17.3 - Under ITP Section 7,2014,0,0,0
Tamil Nadu,17.4 - Under ITP Section 8,2014,0,0,0
Tamil Nadu,17.5 - Other Section of ITP Act,2014,2,1,3
Tamil Nadu,"18 - Juvenile Justice (Care and Protection of Children) Act, 2000",2014,426,59,485
Tamil Nadu,"19 - Protection of Children from Sexual Offences Act, 2012",2014,1126,15,1141
Tamil Nadu,19.1 - Under PCSO Act Section 4,2014,523,15,538
Tamil Nadu,19.2 - Under PCSO Act Section 6,2014,175,0,175
Tamil Nadu,19.3 - Under PCSO Act Section 8,2014,111,0,111
Tamil Nadu,19.4 - Under PCSO Act Section 10,2014,29,0,29
Tamil Nadu,19.5 - Under PCSO Act Sections 14 & 15,2014,22,0,22
Tamil Nadu,19.6 - Other Acts of PCSO,2014,266,0,266
Tamil Nadu,20 - Attempt to commit Murder u/s 307 IPC,2014,26,1,27
Tamil Nadu,21 - Unnatural Offences u/s 377 IPC,2014,3,0,3
Tamil Nadu,22 - Other crimes committed against children,2014,324,10,334
Tamil Nadu,23 - Total crimes against Children,2014,2559,152,2711
Telangana,1 - Murder (Section 302 and 303 IPC),2014,112,7,119
Telangana,2 - Infanticide (Section 315 IPC),2014,6,1,7
Telangana,3 - Rape,2014,879,4,883
Telangana,4 - Assault on women with intent to outrage her Modesty (Section 354 IPC),2014,315,0,315
Telangana,4.1 - Sexual Harassment (Section 354A IPC),2014,126,0,126
Telangana,4.2 - Assault on women with intent to Disrobe (Section 354B IPC),2014,17,0,17
Telangana,4.3 - Voyeurism (Section 354C IPC),2014,2,0,2
Telangana,4.4 - Stalking (Section 354D IPC),2014,37,0,37
Telangana,4.5 - Others assault,2014,133,0,133
Telangana,5 - Insult to the Modesty of Women (Girls Children) (Section 509 IPC),2014,99,0,99
Telangana,"6 - Kidnapping & Abduction_Total (Section 363,364,364A, 366-369 IPC)",2014,748,3,751
Telangana,6.1 - Kidnapping & Abduction (Section 363 IPC),2014,151,0,151
Telangana,6.2 - Kidnaping & Abduction in order to Murder (Section 364 IPC),2014,1,0,1
Telangana,6.3 - Kidnapping for Ransom (Section 364A IPC),2014,2,0,2
Telangana,6.4 - Kidnapping & Abduction of Women to compel her for marriage (Section 366 IPC),2014,387,3,390
Telangana,6.5 - Other Kidnapping,2014,207,0,207
Telangana,7 - Foeticide (Section 315 and 316 IPC),2014,3,0,3
Telangana,8 - Abetment of Suicide of child (Section 305 IPC),2014,4,0,4
Telangana,9 - Exposure and Abandonment (Section 317 IPC),2014,16,0,16
Telangana,10 - Procuration of minor girls (Section 366-A IPC),2014,33,0,33
Telangana,11 - Importation of Girls from Foreign Country (Section 366-B IPC),2014,0,0,0
Telangana,12 - Buying of minors for prostitution (Section 373 IPC),2014,0,0,0
Telangana,13 - Selling of minors for prostitution (Section 372 IPC),2014,0,0,0
Telangana,"14 - Prohibition of Child Marriage Act, 2006",2014,33,9,42
Telangana,"15 - Transplantation of Human Organs Act, 1994",2014,0,0,0
Telangana,"16 - Child Labour (Prohibition & Regulation) Act, 1986",2014,4,0,4
Telangana,16.1 - Offences committed against Migrant,2014,4,0,4
Telangana,16.1.1 - Offences committed against SC migrants,2014,4,0,4
Telangana,16.1.2 - Offences committed against ST migrants,2014,0,0,0
Telangana,16.1.3 - Offences committed against others migrants,2014,0,0,0
Telangana,16.2 - Offences committed against Locals,2014,0,0,0
Telangana,16.2.1 - Offences committed against Local SCs,2014,0,0,0
Telangana,16.2.2 - Offences committed against Local STs,2014,0,0,0
Telangana,16.2.3 - Offences committed against others locals,2014,0,0,0
Telangana,"17 - Immoral Traffic (Prevention) Act, 1956",2014,0,17,17
Telangana,17.1 - Under ITP Section 5,2014,0,16,16
Telangana,17.2 - Under ITP Section 6,2014,0,0,0
Telangana,17.3 - Under ITP Section 7,2014,0,0,0
Telangana,17.4 - Under ITP Section 8,2014,0,0,0
Telangana,17.5 - Other Section of ITP Act,2014,0,1,1
Telangana,"18 - Juvenile Justice (Care and Protection of Children) Act, 2000",2014,51,5,56
Telangana,"19 - Protection of Children from Sexual Offences Act, 2012",2014,35,0,35
Telangana,19.1 - Under PCSO Act Section 4,2014,5,0,5
Telangana,19.2 - Under PCSO Act Section 6,2014,1,0,1
Telangana,19.3 - Under PCSO Act Section 8,2014,13,0,13
Telangana,19.4 - Under PCSO Act Section 10,2014,0,0,0
Telangana,19.5 - Under PCSO Act Sections 14 & 15,2014,0,0,0
Telangana,19.6 - Other Acts of PCSO,2014,16,0,16
Telangana,20 - Attempt to commit Murder u/s 307 IPC,2014,513,26,539
Telangana,21 - Unnatural Offences u/s 377 IPC,2014,9,0,9
Telangana,22 - Other crimes committed against children,2014,336,9,345
Telangana,23 - Total crimes against Children,2014,3196,81,3277
Tripura,1 - Murder (Section 302 and 303 IPC),2014,15,3,18
Tripura,2 - Infanticide (Section 315 IPC),2014,0,0,0
Tripura,3 - Rape,2014,119,0,119
Tripura,4 - Assault on women with intent to outrage her Modesty (Section 354 IPC),2014,78,0,78
Tripura,4.1 - Sexual Harassment (Section 354A IPC),2014,15,0,15
Tripura,4.2 - Assault on women with intent to Disrobe (Section 354B IPC),2014,29,0,29
Tripura,4.3 - Voyeurism (Section 354C IPC),2014,0,0,0
Tripura,4.4 - Stalking (Section 354D IPC),2014,1,0,1
Tripura,4.5 - Others assault,2014,33,0,33
Tripura,5 - Insult to the Modesty of Women (Girls Children) (Section 509 IPC),2014,0,0,0
Tripura,"6 - Kidnapping & Abduction_Total (Section 363,364,364A, 366-369 IPC)",2014,73,1,74
Tripura,6.1 - Kidnapping & Abduction (Section 363 IPC),2014,0,0,0
Tripura,6.2 - Kidnaping & Abduction in order to Murder (Section 364 IPC),2014,0,0,0
Tripura,6.3 - Kidnapping for Ransom (Section 364A IPC),2014,1,0,1
Tripura,6.4 - Kidnapping & Abduction of Women to compel her for marriage (Section 366 IPC),2014,45,0,45
Tripura,6.5 - Other Kidnapping,2014,27,1,28
Tripura,7 - Foeticide (Section 315 and 316 IPC),2014,0,0,0
Tripura,8 - Abetment of Suicide of child (Section 305 IPC),2014,0,0,0
Tripura,9 - Exposure and Abandonment (Section 317 IPC),2014,0,0,0
Tripura,10 - Procuration of minor girls (Section 366-A IPC),2014,0,0,0
Tripura,11 - Importation of Girls from Foreign Country (Section 366-B IPC),2014,0,0,0
Tripura,12 - Buying of minors for prostitution (Section 373 IPC),2014,0,0,0
Tripura,13 - Selling of minors for prostitution (Section 372 IPC),2014,0,0,0
Tripura,"14 - Prohibition of Child Marriage Act, 2006",2014,1,1,2
Tripura,"15 - Transplantation of Human Organs Act, 1994",2014,0,0,0
Tripura,"16 - Child Labour (Prohibition & Regulation) Act, 1986",2014,0,0,0
Tripura,16.1 - Offences committed against Migrant,2014,0,0,0
Tripura,16.1.1 - Offences committed against SC migrants,2014,0,0,0
Tripura,16.1.2 - Offences committed against ST migrants,2014,0,0,0
Tripura,16.1.3 - Offences committed against others migrants,2014,0,0,0
Tripura,16.2 - Offences committed against Locals,2014,0,0,0
Tripura,16.2.1 - Offences committed against Local SCs,2014,0,0,0
Tripura,16.2.2 - Offences committed against Local STs,2014,0,0,0
Tripura,16.2.3 - Offences committed against others locals,2014,0,0,0
Tripura,"17 - Immoral Traffic (Prevention) Act, 1956",2014,0,0,0
Tripura,17.1 - Under ITP Section 5,2014,0,0,0
Tripura,17.2 - Under ITP Section 6,2014,0,0,0
Tripura,17.3 - Under ITP Section 7,2014,0,0,0
Tripura,17.4 - Under ITP Section 8,2014,0,0,0
Tripura,17.5 - Other Section of ITP Act,2014,0,0,0
Tripura,"18 - Juvenile Justice (Care and Protection of Children) Act, 2000",2014,0,0,0
Tripura,"19 - Protection of Children from Sexual Offences Act, 2012",2014,31,0,31
Tripura,19.1 - Under PCSO Act Section 4,2014,13,0,13
Tripura,19.2 - Under PCSO Act Section 6,2014,15,0,15
Tripura,19.3 - Under PCSO Act Section 8,2014,1,0,1
Tripura,19.4 - Under PCSO Act Section 10,2014,0,0,0
Tripura,19.5 - Under PCSO Act Sections 14 & 15,2014,0,0,0
Tripura,19.6 - Other Acts of PCSO,2014,2,0,2
Tripura,20 - Attempt to commit Murder u/s 307 IPC,2014,7,0,7
Tripura,21 - Unnatural Offences u/s 377 IPC,2014,2,0,2
Tripura,22 - Other crimes committed against children,2014,4,0,4
Tripura,23 - Total crimes against Children,2014,330,5,335
Uttar Pradesh,1 - Murder (Section 302 and 303 IPC),2014,1087,17,1104
Uttar Pradesh,2 - Infanticide (Section 315 IPC),2014,25,0,25
Uttar Pradesh,3 - Rape,2014,2343,3,2346
Uttar Pradesh,4 - Assault on women with intent to outrage her Modesty (Section 354 IPC),2014,4385,0,4385
Uttar Pradesh,4.1 - Sexual Harassment (Section 354A IPC),2014,2103,0,2103
Uttar Pradesh,4.2 - Assault on women with intent to Disrobe (Section 354B IPC),2014,547,0,547
Uttar Pradesh,4.3 - Voyeurism (Section 354C IPC),2014,36,0,36
Uttar Pradesh,4.4 - Stalking (Section 354D IPC),2014,468,0,468
Uttar Pradesh,4.5 - Others assault,2014,1231,0,1231
Uttar Pradesh,5 - Insult to the Modesty of Women (Girls Children) (Section 509 IPC),2014,4,0,4
Uttar Pradesh,"6 - Kidnapping & Abduction_Total (Section 363,364,364A, 366-369 IPC)",2014,10966,571,11537
Uttar Pradesh,6.1 - Kidnapping & Abduction (Section 363 IPC),2014,2475,243,2718
Uttar Pradesh,6.2 - Kidnaping & Abduction in order to Murder (Section 364 IPC),2014,188,4,192
Uttar Pradesh,6.3 - Kidnapping for Ransom (Section 364A IPC),2014,158,0,158
Uttar Pradesh,6.4 - Kidnapping & Abduction of Women to compel her for marriage (Section 366 IPC),2014,7668,318,7986
Uttar Pradesh,6.5 - Other Kidnapping,2014,477,6,483
Uttar Pradesh,7 - Foeticide (Section 315 and 316 IPC),2014,21,0,21
Uttar Pradesh,8 - Abetment of Suicide of child (Section 305 IPC),2014,1,0,1
Uttar Pradesh,9 - Exposure and Abandonment (Section 317 IPC),2014,0,0,0
Uttar Pradesh,10 - Procuration of minor girls (Section 366-A IPC),2014,0,0,0
Uttar Pradesh,11 - Importation of Girls from Foreign Country (Section 366-B IPC),2014,0,0,0
Uttar Pradesh,12 - Buying of minors for prostitution (Section 373 IPC),2014,0,0,0
Uttar Pradesh,13 - Selling of minors for prostitution (Section 372 IPC),2014,0,0,0
Uttar Pradesh,"14 - Prohibition of Child Marriage Act, 2006",2014,29,4,33
Uttar Pradesh,"15 - Transplantation of Human Organs Act, 1994",2014,0,0,0
Uttar Pradesh,"16 - Child Labour (Prohibition & Regulation) Act, 1986",2014,5,0,5
Uttar Pradesh,16.1 - Offences committed against Migrant,2014,0,0,0
Uttar Pradesh,16.1.1 - Offences committed against SC migrants,2014,0,0,0
Uttar Pradesh,16.1.2 - Offences committed against ST migrants,2014,0,0,0
Uttar Pradesh,16.1.3 - Offences committed against others migrants,2014,0,0,0
Uttar Pradesh,16.2 - Offences committed against Locals,2014,5,0,5
Uttar Pradesh,16.2.1 - Offences committed against Local SCs,2014,0,0,0
Uttar Pradesh,16.2.2 - Offences committed against Local STs,2014,0,0,0
Uttar Pradesh,16.2.3 - Offences committed against others locals,2014,5,0,5
Uttar Pradesh,"17 - Immoral Traffic (Prevention) Act, 1956",2014,3,3,6
Uttar Pradesh,17.1 - Under ITP Section 5,2014,0,0,0
Uttar Pradesh,17.2 - Under ITP Section 6,2014,3,3,6
Uttar Pradesh,17.3 - Under ITP Section 7,2014,0,0,0
Uttar Pradesh,17.4 - Under ITP Section 8,2014,0,0,0
Uttar Pradesh,17.5 - Other Section of ITP Act,2014,0,0,0
Uttar Pradesh,"18 - Juvenile Justice (Care and Protection of Children) Act, 2000",2014,4,0,4
Uttar Pradesh,"19 - Protection of Children from Sexual Offences Act, 2012",2014,6018,0,6018
Uttar Pradesh,19.1 - Under PCSO Act Section 4,2014,2828,0,2828
Uttar Pradesh,19.2 - Under PCSO Act Section 6,2014,372,0,372
Uttar Pradesh,19.3 - Under PCSO Act Section 8,2014,2217,0,2217
Uttar Pradesh,19.4 - Under PCSO Act Section 10,2014,36,0,36
Uttar Pradesh,19.5 - Under PCSO Act Sections 14 & 15,2014,13,0,13
Uttar Pradesh,19.6 - Other Acts of PCSO,2014,552,0,552
Uttar Pradesh,20 - Attempt to commit Murder u/s 307 IPC,2014,20,0,20
Uttar Pradesh,21 - Unnatural Offences u/s 377 IPC,2014,120,0,120
Uttar Pradesh,22 - Other crimes committed against children,2014,389,1,390
Uttar Pradesh,23 - Total crimes against Children,2014,25420,599,26019
Uttarakhand,1 - Murder (Section 302 and 303 IPC),2014,12,0,12
Uttarakhand,2 - Infanticide (Section 315 IPC),2014,0,0,0
Uttarakhand,3 - Rape,2014,93,3,96
Uttarakhand,4 - Assault on women with intent to outrage her Modesty (Section 354 IPC),2014,20,0,20
Uttarakhand,4.1 - Sexual Harassment (Section 354A IPC),2014,4,0,4
Uttarakhand,4.2 - Assault on women with intent to Disrobe (Section 354B IPC),2014,0,0,0
Uttarakhand,4.3 - Voyeurism (Section 354C IPC),2014,0,0,0
Uttarakhand,4.4 - Stalking (Section 354D IPC),2014,0,0,0
Uttarakhand,4.5 - Others assault,2014,16,0,16
Uttarakhand,5 - Insult to the Modesty of Women (Girls Children) (Section 509 IPC),2014,0,0,0
Uttarakhand,"6 - Kidnapping & Abduction_Total (Section 363,364,364A, 366-369 IPC)",2014,118,0,118
Uttarakhand,6.1 - Kidnapping & Abduction (Section 363 IPC),2014,53,0,53
Uttarakhand,6.2 - Kidnaping & Abduction in order to Murder (Section 364 IPC),2014,1,0,1
Uttarakhand,6.3 - Kidnapping for Ransom (Section 364A IPC),2014,1,0,1
Uttarakhand,6.4 - Kidnapping & Abduction of Women to compel her for marriage (Section 366 IPC),2014,3,0,3
Uttarakhand,6.5 - Other Kidnapping,2014,60,0,60
Uttarakhand,7 - Foeticide (Section 315 and 316 IPC),2014,1,0,1
Uttarakhand,8 - Abetment of Suicide of child (Section 305 IPC),2014,0,0,0
Uttarakhand,9 - Exposure and Abandonment (Section 317 IPC),2014,0,0,0
Uttarakhand,10 - Procuration of minor girls (Section 366-A IPC),2014,0,0,0
Uttarakhand,11 - Importation of Girls from Foreign Country (Section 366-B IPC),2014,0,0,0
Uttarakhand,12 - Buying of minors for prostitution (Section 373 IPC),2014,0,0,0
Uttarakhand,13 - Selling of minors for prostitution (Section 372 IPC),2014,0,0,0
Uttarakhand,"14 - Prohibition of Child Marriage Act, 2006",2014,0,0,0
Uttarakhand,"15 - Transplantation of Human Organs Act, 1994",2014,0,0,0
Uttarakhand,"16 - Child Labour (Prohibition & Regulation) Act, 1986",2014,7,0,7
Uttarakhand,16.1 - Offences committed against Migrant,2014,7,0,7
Uttarakhand,16.1.1 - Offences committed against SC migrants,2014,0,0,0
Uttarakhand,16.1.2 - Offences committed against ST migrants,2014,0,0,0
Uttarakhand,16.1.3 - Offences committed against others migrants,2014,7,0,7
Uttarakhand,16.2 - Offences committed against Locals,2014,0,0,0
Uttarakhand,16.2.1 - Offences committed against Local SCs,2014,0,0,0
Uttarakhand,16.2.2 - Offences committed against Local STs,2014,0,0,0
Uttarakhand,16.2.3 - Offences committed against others locals,2014,0,0,0
Uttarakhand,"17 - Immoral Traffic (Prevention) Act, 1956",2014,3,0,3
Uttarakhand,17.1 - Under ITP Section 5,2014,3,0,3
Uttarakhand,17.2 - Under ITP Section 6,2014,0,0,0
Uttarakhand,17.3 - Under ITP Section 7,2014,0,0,0
Uttarakhand,17.4 - Under ITP Section 8,2014,0,0,0
Uttarakhand,17.5 - Other Section of ITP Act,2014,0,0,0
Uttarakhand,"18 - Juvenile Justice (Care and Protection of Children) Act, 2000",2014,6,0,6
Uttarakhand,"19 - Protection of Children from Sexual Offences Act, 2012",2014,68,2,70
Uttarakhand,19.1 - Under PCSO Act Section 4,2014,19,0,19
Uttarakhand,19.2 - Under PCSO Act Section 6,2014,2,0,2
Uttarakhand,19.3 - Under PCSO Act Section 8,2014,26,0,26
Uttarakhand,19.4 - Under PCSO Act Section 10,2014,1,0,1
Uttarakhand,19.5 - Under PCSO Act Sections 14 & 15,2014,0,0,0
Uttarakhand,19.6 - Other Acts of PCSO,2014,20,2,22
Uttarakhand,20 - Attempt to commit Murder u/s 307 IPC,2014,0,0,0
Uttarakhand,21 - Unnatural Offences u/s 377 IPC,2014,16,0,16
Uttarakhand,22 - Other crimes committed against children,2014,13,0,13
Uttarakhand,23 - Total crimes against Children,2014,357,5,362
West Bengal,1 - Murder (Section 302 and 303 IPC),2014,125,3,128
West Bengal,2 - Infanticide (Section 315 IPC),2014,0,0,0
West Bengal,3 - Rape,2014,0,0,0
West Bengal,4 - Assault on women with intent to outrage her Modesty (Section 354 IPC),2014,184,0,184
West Bengal,4.1 - Sexual Harassment (Section 354A IPC),2014,49,0,49
West Bengal,4.2 - Assault on women with intent to Disrobe (Section 354B IPC),2014,35,0,35
West Bengal,4.3 - Voyeurism (Section 354C IPC),2014,1,0,1
West Bengal,4.4 - Stalking (Section 354D IPC),2014,7,0,7
West Bengal,4.5 - Others assault,2014,92,0,92
West Bengal,5 - Insult to the Modesty of Women (Girls Children) (Section 509 IPC),2014,14,0,14
West Bengal,"6 - Kidnapping & Abduction_Total (Section 363,364,364A, 366-369 IPC)",2014,2347,85,2432
West Bengal,6.1 - Kidnapping & Abduction (Section 363 IPC),2014,931,13,944
West Bengal,6.2 - Kidnaping & Abduction in order to Murder (Section 364 IPC),2014,2,0,2
West Bengal,6.3 - Kidnapping for Ransom (Section 364A IPC),2014,36,0,36
West Bengal,6.4 - Kidnapping & Abduction of Women to compel her for marriage (Section 366 IPC),2014,396,0,396
West Bengal,6.5 - Other Kidnapping,2014,982,72,1054
West Bengal,7 - Foeticide (Section 315 and 316 IPC),2014,0,0,0
West Bengal,8 - Abetment of Suicide of child (Section 305 IPC),2014,6,0,6
West Bengal,9 - Exposure and Abandonment (Section 317 IPC),2014,0,0,0
West Bengal,10 - Procuration of minor girls (Section 366-A IPC),2014,886,13,899
West Bengal,11 - Importation of Girls from Foreign Country (Section 366-B IPC),2014,4,2,6
West Bengal,12 - Buying of minors for prostitution (Section 373 IPC),2014,15,0,15
West Bengal,13 - Selling of minors for prostitution (Section 372 IPC),2014,82,7,89
West Bengal,"14 - Prohibition of Child Marriage Act, 2006",2014,71,3,74
West Bengal,"15 - Transplantation of Human Organs Act, 1994",2014,0,0,0
West Bengal,"16 - Child Labour (Prohibition & Regulation) Act, 1986",2014,7,0,7
West Bengal,16.1 - Offences committed against Migrant,2014,4,0,4
West Bengal,16.1.1 - Offences committed against SC migrants,2014,0,0,0
West Bengal,16.1.2 - Offences committed against ST migrants,2014,0,0,0
West Bengal,16.1.3 - Offences committed against others migrants,2014,4,0,4
West Bengal,16.2 - Offences committed against Locals,2014,3,0,3
West Bengal,16.2.1 - Offences committed against Local SCs,2014,0,0,0
West Bengal,16.2.2 - Offences committed against Local STs,2014,0,0,0
West Bengal,16.2.3 - Offences committed against others locals,2014,3,0,3
West Bengal,"17 - Immoral Traffic (Prevention) Act, 1956",2014,65,29,94
West Bengal,17.1 - Under ITP Section 5,2014,10,0,10
West Bengal,17.2 - Under ITP Section 6,2014,0,0,0
West Bengal,17.3 - Under ITP Section 7,2014,0,0,0
West Bengal,17.4 - Under ITP Section 8,2014,0,0,0
West Bengal,17.5 - Other Section of ITP Act,2014,55,29,84
West Bengal,"18 - Juvenile Justice (Care and Protection of Children) Act, 2000",2014,21,4,25
West Bengal,"19 - Protection of Children from Sexual Offences Act, 2012",2014,864,0,864
West Bengal,19.1 - Under PCSO Act Section 4,2014,629,0,629
West Bengal,19.2 - Under PCSO Act Section 6,2014,31,0,31
West Bengal,19.3 - Under PCSO Act Section 8,2014,38,0,38
West Bengal,19.4 - Under PCSO Act Section 10,2014,7,0,7
West Bengal,19.5 - Under PCSO Act Sections 14 & 15,2014,3,0,3
West Bengal,19.6 - Other Acts of PCSO,2014,156,0,156
West Bengal,20 - Attempt to commit Murder u/s 307 IPC,2014,151,15,166
West Bengal,21 - Unnatural Offences u/s 377 IPC,2014,12,0,12
West Bengal,22 - Other crimes committed against children,2014,245,6,251
West Bengal,23 - Total crimes against Children,2014,5099,167,5266
A & N Islands,1 - Murder (Section 302 and 303 IPC),2014,0,1,1
A & N Islands,2 - Infanticide (Section 315 IPC),2014,0,0,0
A & N Islands,3 - Rape,2014,21,3,24
A & N Islands,4 - Assault on women with intent to outrage her Modesty (Section 354 IPC),2014,10,0,10
A & N Islands,4.1 - Sexual Harassment (Section 354A IPC),2014,6,0,6
A & N Islands,4.2 - Assault on women with intent to Disrobe (Section 354B IPC),2014,0,0,0
A & N Islands,4.3 - Voyeurism (Section 354C IPC),2014,0,0,0
A & N Islands,4.4 - Stalking (Section 354D IPC),2014,2,0,2
A & N Islands,4.5 - Others assault,2014,2,0,2
A & N Islands,5 - Insult to the Modesty of Women (Girls Children) (Section 509 IPC),2014,0,0,0
A & N Islands,"6 - Kidnapping & Abduction_Total (Section 363,364,364A, 366-369 IPC)",2014,8,0,8
A & N Islands,6.1 - Kidnapping & Abduction (Section 363 IPC),2014,6,0,6
A & N Islands,6.2 - Kidnaping & Abduction in order to Murder (Section 364 IPC),2014,0,0,0
A & N Islands,6.3 - Kidnapping for Ransom (Section 364A IPC),2014,0,0,0
A & N Islands,6.4 - Kidnapping & Abduction of Women to compel her for marriage (Section 366 IPC),2014,0,0,0
A & N Islands,6.5 - Other Kidnapping,2014,2,0,2
A & N Islands,7 - Foeticide (Section 315 and 316 IPC),2014,0,0,0
A & N Islands,8 - Abetment of Suicide of child (Section 305 IPC),2014,0,0,0
A & N Islands,9 - Exposure and Abandonment (Section 317 IPC),2014,0,0,0
A & N Islands,10 - Procuration of minor girls (Section 366-A IPC),2014,0,0,0
A & N Islands,11 - Importation of Girls from Foreign Country (Section 366-B IPC),2014,0,0,0
A & N Islands,12 - Buying of minors for prostitution (Section 373 IPC),2014,0,0,0
A & N Islands,13 - Selling of minors for prostitution (Section 372 IPC),2014,0,0,0
A & N Islands,"14 - Prohibition of Child Marriage Act, 2006",2014,0,0,0
A & N Islands,"15 - Transplantation of Human Organs Act, 1994",2014,0,0,0
A & N Islands,"16 - Child Labour (Prohibition & Regulation) Act, 1986",2014,0,0,0
A & N Islands,16.1 - Offences committed against Migrant,2014,0,0,0
A & N Islands,16.1.1 - Offences committed against SC migrants,2014,0,0,0
A & N Islands,16.1.2 - Offences committed against ST migrants,2014,0,0,0
A & N Islands,16.1.3 - Offences committed against others migrants,2014,0,0,0
A & N Islands,16.2 - Offences committed against Locals,2014,0,0,0
A & N Islands,16.2.1 - Offences committed against Local SCs,2014,0,0,0
A & N Islands,16.2.2 - Offences committed against Local STs,2014,0,0,0
A & N Islands,16.2.3 - Offences committed against others locals,2014,0,0,0
A & N Islands,"17 - Immoral Traffic (Prevention) Act, 1956",2014,1,2,3
A & N Islands,17.1 - Under ITP Section 5,2014,1,2,3
A & N Islands,17.2 - Under ITP Section 6,2014,0,0,0
A & N Islands,17.3 - Under ITP Section 7,2014,0,0,0
A & N Islands,17.4 - Under ITP Section 8,2014,0,0,0
A & N Islands,17.5 - Other Section of ITP Act,2014,0,0,0
A & N Islands,"18 - Juvenile Justice (Care and Protection of Children) Act, 2000",2014,0,1,1
A & N Islands,"19 - Protection of Children from Sexual Offences Act, 2012",2014,0,0,0
A & N Islands,19.1 - Under PCSO Act Section 4,2014,0,0,0
A & N Islands,19.2 - Under PCSO Act Section 6,2014,0,0,0
A & N Islands,19.3 - Under PCSO Act Section 8,2014,0,0,0
A & N Islands,19.4 - Under PCSO Act Section 10,2014,0,0,0
A & N Islands,19.5 - Under PCSO Act Sections 14 & 15,2014,0,0,0
A & N Islands,19.6 - Other Acts of PCSO,2014,0,0,0
A & N Islands,20 - Attempt to commit Murder u/s 307 IPC,2014,0,0,0
A & N Islands,21 - Unnatural Offences u/s 377 IPC,2014,3,0,3
A & N Islands,22 - Other crimes committed against children,2014,6,1,7
A & N Islands,23 - Total crimes against Children,2014,49,8,57
Chandigarh,1 - Murder (Section 302 and 303 IPC),2014,2,1,3
Chandigarh,2 - Infanticide (Section 315 IPC),2014,0,0,0
Chandigarh,3 - Rape,2014,34,0,34
Chandigarh,4 - Assault on women with intent to outrage her Modesty (Section 354 IPC),2014,20,0,20
Chandigarh,4.1 - Sexual Harassment (Section 354A IPC),2014,9,0,9
Chandigarh,4.2 - Assault on women with intent to Disrobe (Section 354B IPC),2014,0,0,0
Chandigarh,4.3 - Voyeurism (Section 354C IPC),2014,0,0,0
Chandigarh,4.4 - Stalking (Section 354D IPC),2014,1,0,1
Chandigarh,4.5 - Others assault,2014,10,0,10
Chandigarh,5 - Insult to the Modesty of Women (Girls Children) (Section 509 IPC),2014,0,0,0
Chandigarh,"6 - Kidnapping & Abduction_Total (Section 363,364,364A, 366-369 IPC)",2014,48,0,48
Chandigarh,6.1 - Kidnapping & Abduction (Section 363 IPC),2014,13,0,13
Chandigarh,6.2 - Kidnaping & Abduction in order to Murder (Section 364 IPC),2014,0,0,0
Chandigarh,6.3 - Kidnapping for Ransom (Section 364A IPC),2014,0,0,0
Chandigarh,6.4 - Kidnapping & Abduction of Women to compel her for marriage (Section 366 IPC),2014,32,0,32
Chandigarh,6.5 - Other Kidnapping,2014,3,0,3
Chandigarh,7 - Foeticide (Section 315 and 316 IPC),2014,0,0,0
Chandigarh,8 - Abetment of Suicide of child (Section 305 IPC),2014,0,0,0
Chandigarh,9 - Exposure and Abandonment (Section 317 IPC),2014,0,0,0
Chandigarh,10 - Procuration of minor girls (Section 366-A IPC),2014,0,0,0
Chandigarh,11 - Importation of Girls from Foreign Country (Section 366-B IPC),2014,0,0,0
Chandigarh,12 - Buying of minors for prostitution (Section 373 IPC),2014,0,0,0
Chandigarh,13 - Selling of minors for prostitution (Section 372 IPC),2014,0,0,0
Chandigarh,"14 - Prohibition of Child Marriage Act, 2006",2014,0,0,0
Chandigarh,"15 - Transplantation of Human Organs Act, 1994",2014,0,0,0
Chandigarh,"16 - Child Labour (Prohibition & Regulation) Act, 1986",2014,0,0,0
Chandigarh,16.1 - Offences committed against Migrant,2014,0,0,0
Chandigarh,16.1.1 - Offences committed against SC migrants,2014,0,0,0
Chandigarh,16.1.2 - Offences committed against ST migrants,2014,0,0,0
Chandigarh,16.1.3 - Offences committed against others migrants,2014,0,0,0
Chandigarh,16.2 - Offences committed against Locals,2014,0,0,0
Chandigarh,16.2.1 - Offences committed against Local SCs,2014,0,0,0
Chandigarh,16.2.2 - Offences committed against Local STs,2014,0,0,0
Chandigarh,16.2.3 - Offences committed against others locals,2014,0,0,0
Chandigarh,"17 - Immoral Traffic (Prevention) Act, 1956",2014,0,0,0
Chandigarh,17.1 - Under ITP Section 5,2014,0,0,0
Chandigarh,17.2 - Under ITP Section 6,2014,0,0,0
Chandigarh,17.3 - Under ITP Section 7,2014,0,0,0
Chandigarh,17.4 - Under ITP Section 8,2014,0,0,0
Chandigarh,17.5 - Other Section of ITP Act,2014,0,0,0
Chandigarh,"18 - Juvenile Justice (Care and Protection of Children) Act, 2000",2014,12,0,12
Chandigarh,"19 - Protection of Children from Sexual Offences Act, 2012",2014,0,0,0
Chandigarh,19.1 - Under PCSO Act Section 4,2014,0,0,0
Chandigarh,19.2 - Under PCSO Act Section 6,2014,0,0,0
Chandigarh,19.3 - Under PCSO Act Section 8,2014,0,0,0
Chandigarh,19.4 - Under PCSO Act Section 10,2014,0,0,0
Chandigarh,19.5 - Under PCSO Act Sections 14 & 15,2014,0,0,0
Chandigarh,19.6 - Other Acts of PCSO,2014,0,0,0
Chandigarh,20 - Attempt to commit Murder u/s 307 IPC,2014,0,0,0
Chandigarh,21 - Unnatural Offences u/s 377 IPC,2014,3,0,3
Chandigarh,22 - Other crimes committed against children,2014,14,0,14
Chandigarh,23 - Total crimes against Children,2014,133,1,134
D&N Haveli,1 - Murder (Section 302 and 303 IPC),2014,1,0,1
D&N Haveli,2 - Infanticide (Section 315 IPC),2014,0,0,0
D&N Haveli,3 - Rape,2014,2,1,3
D&N Haveli,4 - Assault on women with intent to outrage her Modesty (Section 354 IPC),2014,0,0,0
D&N Haveli,4.1 - Sexual Harassment (Section 354A IPC),2014,0,0,0
D&N Haveli,4.2 - Assault on women with intent to Disrobe (Section 354B IPC),2014,0,0,0
D&N Haveli,4.3 - Voyeurism (Section 354C IPC),2014,0,0,0
D&N Haveli,4.4 - Stalking (Section 354D IPC),2014,0,0,0
D&N Haveli,4.5 - Others assault,2014,0,0,0
D&N Haveli,5 - Insult to the Modesty of Women (Girls Children) (Section 509 IPC),2014,0,0,0
D&N Haveli,"6 - Kidnapping & Abduction_Total (Section 363,364,364A, 366-369 IPC)",2014,3,0,3
D&N Haveli,6.1 - Kidnapping & Abduction (Section 363 IPC),2014,3,0,3
D&N Haveli,6.2 - Kidnaping & Abduction in order to Murder (Section 364 IPC),2014,0,0,0
D&N Haveli,6.3 - Kidnapping for Ransom (Section 364A IPC),2014,0,0,0
D&N Haveli,6.4 - Kidnapping & Abduction of Women to compel her for marriage (Section 366 IPC),2014,0,0,0
D&N Haveli,6.5 - Other Kidnapping,2014,0,0,0
D&N Haveli,7 - Foeticide (Section 315 and 316 IPC),2014,0,0,0
D&N Haveli,8 - Abetment of Suicide of child (Section 305 IPC),2014,0,0,0
D&N Haveli,9 - Exposure and Abandonment (Section 317 IPC),2014,0,0,0
D&N Haveli,10 - Procuration of minor girls (Section 366-A IPC),2014,0,0,0
D&N Haveli,11 - Importation of Girls from Foreign Country (Section 366-B IPC),2014,0,0,0
D&N Haveli,12 - Buying of minors for prostitution (Section 373 IPC),2014,0,0,0
D&N Haveli,13 - Selling of minors for prostitution (Section 372 IPC),2014,0,0,0
D&N Haveli,"14 - Prohibition of Child Marriage Act, 2006",2014,0,0,0
D&N Haveli,"15 - Transplantation of Human Organs Act, 1994",2014,0,0,0
D&N Haveli,"16 - Child Labour (Prohibition & Regulation) Act, 1986",2014,0,0,0
D&N Haveli,16.1 - Offences committed against Migrant,2014,0,0,0
D&N Haveli,16.1.1 - Offences committed against SC migrants,2014,0,0,0
D&N Haveli,16.1.2 - Offences committed against ST migrants,2014,0,0,0
D&N Haveli,16.1.3 - Offences committed against others migrants,2014,0,0,0
D&N Haveli,16.2 - Offences committed against Locals,2014,0,0,0
D&N Haveli,16.2.1 - Offences committed against Local SCs,2014,0,0,0
D&N Haveli,16.2.2 - Offences committed against Local STs,2014,0,0,0
D&N Haveli,16.2.3 - Offences committed against others locals,2014,0,0,0
D&N Haveli,"17 - Immoral Traffic (Prevention) Act, 1956",2014,0,0,0
D&N Haveli,17.1 - Under ITP Section 5,2014,0,0,0
D&N Haveli,17.2 - Under ITP Section 6,2014,0,0,0
D&N Haveli,17.3 - Under ITP Section 7,2014,0,0,0
D&N Haveli,17.4 - Under ITP Section 8,2014,0,0,0
D&N Haveli,17.5 - Other Section of ITP Act,2014,0,0,0
D&N Haveli,"18 - Juvenile Justice (Care and Protection of Children) Act, 2000",2014,0,0,0
D&N Haveli,"19 - Protection of Children from Sexual Offences Act, 2012",2014,0,0,0
D&N Haveli,19.1 - Under PCSO Act Section 4,2014,0,0,0
D&N Haveli,19.2 - Under PCSO Act Section 6,2014,0,0,0
D&N Haveli,19.3 - Under PCSO Act Section 8,2014,0,0,0
D&N Haveli,19.4 - Under PCSO Act Section 10,2014,0,0,0
D&N Haveli,19.5 - Under PCSO Act Sections 14 & 15,2014,0,0,0
D&N Haveli,19.6 - Other Acts of PCSO,2014,0,0,0
D&N Haveli,20 - Attempt to commit Murder u/s 307 IPC,2014,0,0,0
D&N Haveli,21 - Unnatural Offences u/s 377 IPC,2014,0,0,0
D&N Haveli,22 - Other crimes committed against children,2014,0,0,0
D&N Haveli,23 - Total crimes against Children,2014,6,1,7
Daman & Diu,1 - Murder (Section 302 and 303 IPC),2014,0,0,0
Daman & Diu,2 - Infanticide (Section 315 IPC),2014,0,0,0
Daman & Diu,3 - Rape,2014,1,0,1
Daman & Diu,4 - Assault on women with intent to outrage her Modesty (Section 354 IPC),2014,0,0,0
Daman & Diu,4.1 - Sexual Harassment (Section 354A IPC),2014,0,0,0
Daman & Diu,4.2 - Assault on women with intent to Disrobe (Section 354B IPC),2014,0,0,0
Daman & Diu,4.3 - Voyeurism (Section 354C IPC),2014,0,0,0
Daman & Diu,4.4 - Stalking (Section 354D IPC),2014,0,0,0
Daman & Diu,4.5 - Others assault,2014,0,0,0
Daman & Diu,5 - Insult to the Modesty of Women (Girls Children) (Section 509 IPC),2014,0,0,0
Daman & Diu,"6 - Kidnapping & Abduction_Total (Section 363,364,364A, 366-369 IPC)",2014,2,0,2
Daman & Diu,6.1 - Kidnapping & Abduction (Section 363 IPC),2014,2,0,2
Daman & Diu,6.2 - Kidnaping & Abduction in order to Murder (Section 364 IPC),2014,0,0,0
Daman & Diu,6.3 - Kidnapping for Ransom (Section 364A IPC),2014,0,0,0
Daman & Diu,6.4 - Kidnapping & Abduction of Women to compel her for marriage (Section 366 IPC),2014,0,0,0
Daman & Diu,6.5 - Other Kidnapping,2014,0,0,0
Daman & Diu,7 - Foeticide (Section 315 and 316 IPC),2014,0,0,0
Daman & Diu,8 - Abetment of Suicide of child (Section 305 IPC),2014,0,1,1
Daman & Diu,9 - Exposure and Abandonment (Section 317 IPC),2014,1,1,2
Daman & Diu,10 - Procuration of minor girls (Section 366-A IPC),2014,0,0,0
Daman & Diu,11 - Importation of Girls from Foreign Country (Section 366-B IPC),2014,0,0,0
Daman & Diu,12 - Buying of minors for prostitution (Section 373 IPC),2014,0,0,0
Daman & Diu,13 - Selling of minors for prostitution (Section 372 IPC),2014,0,0,0
Daman & Diu,"14 - Prohibition of Child Marriage Act, 2006",2014,0,0,0
Daman & Diu,"15 - Transplantation of Human Organs Act, 1994",2014,0,0,0
Daman & Diu,"16 - Child Labour (Prohibition & Regulation) Act, 1986",2014,0,0,0
Daman & Diu,16.1 - Offences committed against Migrant,2014,0,0,0
Daman & Diu,16.1.1 - Offences committed against SC migrants,2014,0,0,0
Daman & Diu,16.1.2 - Offences committed against ST migrants,2014,0,0,0
Daman & Diu,16.1.3 - Offences committed against others migrants,2014,0,0,0
Daman & Diu,16.2 - Offences committed against Locals,2014,0,0,0
Daman & Diu,16.2.1 - Offences committed against Local SCs,2014,0,0,0
Daman & Diu,16.2.2 - Offences committed against Local STs,2014,0,0,0
Daman & Diu,16.2.3 - Offences committed against others locals,2014,0,0,0
Daman & Diu,"17 - Immoral Traffic (Prevention) Act, 1956",2014,0,0,0
Daman & Diu,17.1 - Under ITP Section 5,2014,0,0,0
Daman & Diu,17.2 - Under ITP Section 6,2014,0,0,0
Daman & Diu,17.3 - Under ITP Section 7,2014,0,0,0
Daman & Diu,17.4 - Under ITP Section 8,2014,0,0,0
Daman & Diu,17.5 - Other Section of ITP Act,2014,0,0,0
Daman & Diu,"18 - Juvenile Justice (Care and Protection of Children) Act, 2000",2014,0,0,0
Daman & Diu,"19 - Protection of Children from Sexual Offences Act, 2012",2014,0,0,0
Daman & Diu,19.1 - Under PCSO Act Section 4,2014,0,0,0
Daman & Diu,19.2 - Under PCSO Act Section 6,2014,0,0,0
Daman & Diu,19.3 - Under PCSO Act Section 8,2014,0,0,0
Daman & Diu,19.4 - Under PCSO Act Section 10,2014,0,0,0
Daman & Diu,19.5 - Under PCSO Act Sections 14 & 15,2014,0,0,0
Daman & Diu,19.6 - Other Acts of PCSO,2014,0,0,0
Daman & Diu,20 - Attempt to commit Murder u/s 307 IPC,2014,0,0,0
Daman & Diu,21 - Unnatural Offences u/s 377 IPC,2014,0,0,0
Daman & Diu,22 - Other crimes committed against children,2014,0,0,0
Daman & Diu,23 - Total crimes against Children,2014,4,2,6
Delhi UT,1 - Murder (Section 302 and 303 IPC),2014,46,0,46
Delhi UT,2 - Infanticide (Section 315 IPC),2014,3,0,3
Delhi UT,3 - Rape,2014,930,3,933
Delhi UT,4 - Assault on women with intent to outrage her Modesty (Section 354 IPC),2014,829,2,831
Delhi UT,4.1 - Sexual Harassment (Section 354A IPC),2014,260,1,261
Delhi UT,4.2 - Assault on women with intent to Disrobe (Section 354B IPC),2014,49,0,49
Delhi UT,4.3 - Voyeurism (Section 354C IPC),2014,25,0,25
Delhi UT,4.4 - Stalking (Section 354D IPC),2014,91,0,91
Delhi UT,4.5 - Others assault,2014,404,1,405
Delhi UT,5 - Insult to the Modesty of Women (Girls Children) (Section 509 IPC),2014,56,4,60
Delhi UT,"6 - Kidnapping & Abduction_Total (Section 363,364,364A, 366-369 IPC)",2014,484,8,492
Delhi UT,6.1 - Kidnapping & Abduction (Section 363 IPC),2014,467,8,475
Delhi UT,6.2 - Kidnaping & Abduction in order to Murder (Section 364 IPC),2014,0,0,0
Delhi UT,6.3 - Kidnapping for Ransom (Section 364A IPC),2014,13,0,13
Delhi UT,6.4 - Kidnapping & Abduction of Women to compel her for marriage (Section 366 IPC),2014,0,0,0
Delhi UT,6.5 - Other Kidnapping,2014,4,0,4
Delhi UT,7 - Foeticide (Section 315 and 316 IPC),2014,1,0,1
Delhi UT,8 - Abetment of Suicide of child (Section 305 IPC),2014,0,0,0
Delhi UT,9 - Exposure and Abandonment (Section 317 IPC),2014,0,0,0
Delhi UT,10 - Procuration of minor girls (Section 366-A IPC),2014,0,0,0
Delhi UT,11 - Importation of Girls from Foreign Country (Section 366-B IPC),2014,0,0,0
Delhi UT,12 - Buying of minors for prostitution (Section 373 IPC),2014,0,0,0
Delhi UT,13 - Selling of minors for prostitution (Section 372 IPC),2014,2,5,7
Delhi UT,"14 - Prohibition of Child Marriage Act, 2006",2014,1,0,1
Delhi UT,"15 - Transplantation of Human Organs Act, 1994",2014,0,0,0
Delhi UT,"16 - Child Labour (Prohibition & Regulation) Act, 1986",2014,34,1,35
Delhi UT,16.1 - Offences committed against Migrant,2014,8,0,8
Delhi UT,16.1.1 - Offences committed against SC migrants,2014,0,0,0
Delhi UT,16.1.2 - Offences committed against ST migrants,2014,0,0,0
Delhi UT,16.1.3 - Offences committed against others migrants,2014,8,0,8
Delhi UT,16.2 - Offences committed against Locals,2014,26,1,27
Delhi UT,16.2.1 - Offences committed against Local SCs,2014,0,0,0
Delhi UT,16.2.2 - Offences committed against Local STs,2014,0,0,0
Delhi UT,16.2.3 - Offences committed against others locals,2014,26,1,27
Delhi UT,"17 - Immoral Traffic (Prevention) Act, 1956",2014,0,1,1
Delhi UT,17.1 - Under ITP Section 5,2014,0,0,0
Delhi UT,17.2 - Under ITP Section 6,2014,0,0,0
Delhi UT,17.3 - Under ITP Section 7,2014,0,0,0
Delhi UT,17.4 - Under ITP Section 8,2014,0,0,0
Delhi UT,17.5 - Other Section of ITP Act,2014,0,1,1
Delhi UT,"18 - Juvenile Justice (Care and Protection of Children) Act, 2000",2014,95,7,102
Delhi UT,"19 - Protection of Children from Sexual Offences Act, 2012",2014,93,0,93
Delhi UT,19.1 - Under PCSO Act Section 4,2014,8,0,8
Delhi UT,19.2 - Under PCSO Act Section 6,2014,8,0,8
Delhi UT,19.3 - Under PCSO Act Section 8,2014,31,0,31
Delhi UT,19.4 - Under PCSO Act Section 10,2014,14,0,14
Delhi UT,19.5 - Under PCSO Act Sections 14 & 15,2014,0,0,0
Delhi UT,19.6 - Other Acts of PCSO,2014,32,0,32
Delhi UT,20 - Attempt to commit Murder u/s 307 IPC,2014,14,0,14
Delhi UT,21 - Unnatural Offences u/s 377 IPC,2014,125,0,125
Delhi UT,22 - Other crimes committed against children,2014,165,0,165
Delhi UT,23 - Total crimes against Children,2014,2878,31,2909
Lakshadweep,1 - Murder (Section 302 and 303 IPC),2014,0,0,0
Lakshadweep,2 - Infanticide (Section 315 IPC),2014,0,0,0
Lakshadweep,3 - Rape,2014,0,0,0
Lakshadweep,4 - Assault on women with intent to outrage her Modesty (Section 354 IPC),2014,0,0,0
Lakshadweep,4.1 - Sexual Harassment (Section 354A IPC),2014,0,0,0
Lakshadweep,4.2 - Assault on women with intent to Disrobe (Section 354B IPC),2014,0,0,0
Lakshadweep,4.3 - Voyeurism (Section 354C IPC),2014,0,0,0
Lakshadweep,4.4 - Stalking (Section 354D IPC),2014,0,0,0
Lakshadweep,4.5 - Others assault,2014,0,0,0
Lakshadweep,5 - Insult to the Modesty of Women (Girls Children) (Section 509 IPC),2014,0,0,0
Lakshadweep,"6 - Kidnapping & Abduction_Total (Section 363,364,364A, 366-369 IPC)",2014,0,0,0
Lakshadweep,6.1 - Kidnapping & Abduction (Section 363 IPC),2014,0,0,0
Lakshadweep,6.2 - Kidnaping & Abduction in order to Murder (Section 364 IPC),2014,0,0,0
Lakshadweep,6.3 - Kidnapping for Ransom (Section 364A IPC),2014,0,0,0
Lakshadweep,6.4 - Kidnapping & Abduction of Women to compel her for marriage (Section 366 IPC),2014,0,0,0
Lakshadweep,6.5 - Other Kidnapping,2014,0,0,0
Lakshadweep,7 - Foeticide (Section 315 and 316 IPC),2014,0,0,0
Lakshadweep,8 - Abetment of Suicide of child (Section 305 IPC),2014,0,0,0
Lakshadweep,9 - Exposure and Abandonment (Section 317 IPC),2014,0,0,0
Lakshadweep,10 - Procuration of minor girls (Section 366-A IPC),2014,0,0,0
Lakshadweep,11 - Importation of Girls from Foreign Country (Section 366-B IPC),2014,0,0,0
Lakshadweep,12 - Buying of minors for prostitution (Section 373 IPC),2014,0,0,0
Lakshadweep,13 - Selling of minors for prostitution (Section 372 IPC),2014,0,0,0
Lakshadweep,"14 - Prohibition of Child Marriage Act, 2006",2014,0,0,0
Lakshadweep,"15 - Transplantation of Human Organs Act, 1994",2014,0,0,0
Lakshadweep,"16 - Child Labour (Prohibition & Regulation) Act, 1986",2014,0,0,0
Lakshadweep,16.1 - Offences committed against Migrant,2014,0,0,0
Lakshadweep,16.1.1 - Offences committed against SC migrants,2014,0,0,0
Lakshadweep,16.1.2 - Offences committed against ST migrants,2014,0,0,0
Lakshadweep,16.1.3 - Offences committed against others migrants,2014,0,0,0
Lakshadweep,16.2 - Offences committed against Locals,2014,0,0,0
Lakshadweep,16.2.1 - Offences committed against Local SCs,2014,0,0,0
Lakshadweep,16.2.2 - Offences committed against Local STs,2014,0,0,0
Lakshadweep,16.2.3 - Offences committed against others locals,2014,0,0,0
Lakshadweep,"17 - Immoral Traffic (Prevention) Act, 1956",2014,0,0,0
Lakshadweep,17.1 - Under ITP Section 5,2014,0,0,0
Lakshadweep,17.2 - Under ITP Section 6,2014,0,0,0
Lakshadweep,17.3 - Under ITP Section 7,2014,0,0,0
Lakshadweep,17.4 - Under ITP Section 8,2014,0,0,0
Lakshadweep,17.5 - Other Section of ITP Act,2014,0,0,0
Lakshadweep,"18 - Juvenile Justice (Care and Protection of Children) Act, 2000",2014,0,0,0
Lakshadweep,"19 - Protection of Children from Sexual Offences Act, 2012",2014,3,0,3
Lakshadweep,19.1 - Under PCSO Act Section 4,2014,0,0,0
Lakshadweep,19.2 - Under PCSO Act Section 6,2014,0,0,0
Lakshadweep,19.3 - Under PCSO Act Section 8,2014,3,0,3
Lakshadweep,19.4 - Under PCSO Act Section 10,2014,0,0,0
Lakshadweep,19.5 - Under PCSO Act Sections 14 & 15,2014,0,0,0
Lakshadweep,19.6 - Other Acts of PCSO,2014,0,0,0
Lakshadweep,20 - Attempt to commit Murder u/s 307 IPC,2014,0,0,0
Lakshadweep,21 - Unnatural Offences u/s 377 IPC,2014,0,0,0
Lakshadweep,22 - Other crimes committed against children,2014,0,0,0
Lakshadweep,23 - Total crimes against Children,2014,3,0,3
Puducherry,1 - Murder (Section 302 and 303 IPC),2014,0,0,0
Puducherry,2 - Infanticide (Section 315 IPC),2014,0,0,0
Puducherry,3 - Rape,2014,3,0,3
Puducherry,4 - Assault on women with intent to outrage her Modesty (Section 354 IPC),2014,0,0,0
Puducherry,4.1 - Sexual Harassment (Section 354A IPC),2014,0,0,0
Puducherry,4.2 - Assault on women with intent to Disrobe (Section 354B IPC),2014,0,0,0
Puducherry,4.3 - Voyeurism (Section 354C IPC),2014,0,0,0
Puducherry,4.4 - Stalking (Section 354D IPC),2014,0,0,0
Puducherry,4.5 - Others assault,2014,0,0,0
Puducherry,5 - Insult to the Modesty of Women (Girls Children) (Section 509 IPC),2014,0,0,0
Puducherry,"6 - Kidnapping & Abduction_Total (Section 363,364,364A, 366-369 IPC)",2014,5,0,5
Puducherry,6.1 - Kidnapping & Abduction (Section 363 IPC),2014,3,0,3
Puducherry,6.2 - Kidnaping & Abduction in order to Murder (Section 364 IPC),2014,0,0,0
Puducherry,6.3 - Kidnapping for Ransom (Section 364A IPC),2014,1,0,1
Puducherry,6.4 - Kidnapping & Abduction of Women to compel her for marriage (Section 366 IPC),2014,1,0,1
Puducherry,6.5 - Other Kidnapping,2014,0,0,0
Puducherry,7 - Foeticide (Section 315 and 316 IPC),2014,0,0,0
Puducherry,8 - Abetment of Suicide of child (Section 305 IPC),2014,0,0,0
Puducherry,9 - Exposure and Abandonment (Section 317 IPC),2014,0,0,0
Puducherry,10 - Procuration of minor girls (Section 366-A IPC),2014,0,0,0
Puducherry,11 - Importation of Girls from Foreign Country (Section 366-B IPC),2014,0,0,0
Puducherry,12 - Buying of minors for prostitution (Section 373 IPC),2014,0,0,0
Puducherry,13 - Selling of minors for prostitution (Section 372 IPC),2014,0,0,0
Puducherry,"14 - Prohibition of Child Marriage Act, 2006",2014,6,4,10
Puducherry,"15 - Transplantation of Human Organs Act, 1994",2014,0,0,0
Puducherry,"16 - Child Labour (Prohibition & Regulation) Act, 1986",2014,0,0,0
Puducherry,16.1 - Offences committed against Migrant,2014,0,0,0
Puducherry,16.1.1 - Offences committed against SC migrants,2014,0,0,0
Puducherry,16.1.2 - Offences committed against ST migrants,2014,0,0,0
Puducherry,16.1.3 - Offences committed against others migrants,2014,0,0,0
Puducherry,16.2 - Offences committed against Locals,2014,0,0,0
Puducherry,16.2.1 - Offences committed against Local SCs,2014,0,0,0
Puducherry,16.2.2 - Offences committed against Local STs,2014,0,0,0
Puducherry,16.2.3 - Offences committed against others locals,2014,0,0,0
Puducherry,"17 - Immoral Traffic (Prevention) Act, 1956",2014,0,0,0
Puducherry,17.1 - Under ITP Section 5,2014,0,0,0
Puducherry,17.2 - Under ITP Section 6,2014,0,0,0
Puducherry,17.3 - Under ITP Section 7,2014,0,0,0
Puducherry,17.4 - Under ITP Section 8,2014,0,0,0
Puducherry,17.5 - Other Section of ITP Act,2014,0,0,0
Puducherry,"18 - Juvenile Justice (Care and Protection of Children) Act, 2000",2014,0,0,0
Puducherry,"19 - Protection of Children from Sexual Offences Act, 2012",2014,13,2,15
Puducherry,19.1 - Under PCSO Act Section 4,2014,6,2,8
Puducherry,19.2 - Under PCSO Act Section 6,2014,3,0,3
Puducherry,19.3 - Under PCSO Act Section 8,2014,2,0,2
Puducherry,19.4 - Under PCSO Act Section 10,2014,0,0,0
Puducherry,19.5 - Under PCSO Act Sections 14 & 15,2014,0,0,0
Puducherry,19.6 - Other Acts of PCSO,2014,2,0,2
Puducherry,20 - Attempt to commit Murder u/s 307 IPC,2014,1,0,1
Puducherry,21 - Unnatural Offences u/s 377 IPC,2014,0,0,0
Puducherry,22 - Other crimes committed against children,2014,1,0,1
Puducherry,23 - Total crimes against Children,2014,29,6,35
Total (States),1 - Murder (Section 302 and 303 IPC),2014,2556,152,2708
Total (States),2 - Infanticide (Section 315 IPC),2014,70,6,76
Total (States),3 - Rape,2014,15158,219,15377
Total (States),4 - Assault on women with intent to outrage her Modesty (Section 354 IPC),2014,12719,71,12790
Total (States),4.1 - Sexual Harassment (Section 354A IPC),2014,5333,43,5376
Total (States),4.2 - Assault on women with intent to Disrobe (Section 354B IPC),2014,873,1,874
Total (States),4.3 - Voyeurism (Section 354C IPC),2014,95,0,95
Total (States),4.4 - Stalking (Section 354D IPC),2014,1273,4,1277
Total (States),4.5 - Others assault,2014,5145,23,5168
Total (States),5 - Insult to the Modesty of Women (Girls Children) (Section 509 IPC),2014,474,0,474
Total (States),"6 - Kidnapping & Abduction_Total (Section 363,364,364A, 366-369 IPC)",2014,27579,1015,28594
Total (States),6.1 - Kidnapping & Abduction (Section 363 IPC),2014,7676,399,8075
Total (States),6.2 - Kidnaping & Abduction in order to Murder (Section 364 IPC),2014,297,7,304
Total (States),6.3 - Kidnapping for Ransom (Section 364A IPC),2014,347,8,355
Total (States),6.4 - Kidnapping & Abduction of Women to compel her for marriage (Section 366 IPC),2014,14935,461,15396
Total (States),6.5 - Other Kidnapping,2014,4324,140,4464
Total (States),7 - Foeticide (Section 315 and 316 IPC),2014,41,6,47
Total (States),8 - Abetment of Suicide of child (Section 305 IPC),2014,50,5,55
Total (States),9 - Exposure and Abandonment (Section 317 IPC),2014,203,72,275
Total (States),10 - Procuration of minor girls (Section 366-A IPC),2014,1948,19,1967
Total (States),11 - Importation of Girls from Foreign Country (Section 366-B IPC),2014,4,2,6
Total (States),12 - Buying of minors for prostitution (Section 373 IPC),2014,30,1,31
Total (States),13 - Selling of minors for prostitution (Section 372 IPC),2014,92,10,102
Total (States),"14 - Prohibition of Child Marriage Act, 2006",2014,564,143,707
Total (States),"15 - Transplantation of Human Organs Act, 1994",2014,0,0,0
Total (States),"16 - Child Labour (Prohibition & Regulation) Act, 1986",2014,119,2,121
Total (States),16.1 - Offences committed against Migrant,2014,22,0,22
Total (States),16.1.1 - Offences committed against SC migrants,2014,4,0,4
Total (States),16.1.2 - Offences committed against ST migrants,2014,0,0,0
Total (States),16.1.3 - Offences committed against others migrants,2014,18,0,18
Total (States),16.2 - Offences committed against Locals,2014,97,2,99
Total (States),16.2.1 - Offences committed against Local SCs,2014,2,0,2
Total (States),16.2.2 - Offences committed against Local STs,2014,0,0,0
Total (States),16.2.3 - Offences committed against others locals,2014,95,2,97
Total (States),"17 - Immoral Traffic (Prevention) Act, 1956",2014,137,68,205
Total (States),17.1 - Under ITP Section 5,2014,27,17,44
Total (States),17.2 - Under ITP Section 6,2014,4,3,7
Total (States),17.3 - Under ITP Section 7,2014,17,5,22
Total (States),17.4 - Under ITP Section 8,2014,3,1,4
Total (States),17.5 - Other Section of ITP Act,2014,86,42,128
Total (States),"18 - Juvenile Justice (Care and Protection of Children) Act, 2000",2014,1250,124,1374
Total (States),"19 - Protection of Children from Sexual Offences Act, 2012",2014,10917,144,11061
Total (States),19.1 - Under PCSO Act Section 4,2014,5083,70,5153
Total (States),19.2 - Under PCSO Act Section 6,2014,894,10,904
Total (States),19.3 - Under PCSO Act Section 8,2014,2939,17,2956
Total (States),19.4 - Under PCSO Act Section 10,2014,186,31,217
Total (States),19.5 - Under PCSO Act Sections 14 & 15,2014,47,0,47
Total (States),19.6 - Other Acts of PCSO,2014,1768,16,1784
Total (States),20 - Attempt to commit Murder u/s 307 IPC,2014,2383,104,2487
Total (States),21 - Unnatural Offences u/s 377 IPC,2014,733,4,737
Total (States),22 - Other crimes committed against children,2014,10695,420,11115
Total (States),23 - Total crimes against Children,2014,87722,2587,90309
Total (UTs),1 - Murder (Section 302 and 303 IPC),2014,49,2,51
Total (UTs),2 - Infanticide (Section 315 IPC),2014,3,0,3
Total (UTs),3 - Rape,2014,991,7,998
Total (UTs),4 - Assault on women with intent to outrage her Modesty (Section 354 IPC),2014,859,2,861
Total (UTs),4.1 - Sexual Harassment (Section 354A IPC),2014,275,1,276
Total (UTs),4.2 - Assault on women with intent to Disrobe (Section 354B IPC),2014,49,0,49
Total (UTs),4.3 - Voyeurism (Section 354C IPC),2014,25,0,25
Total (UTs),4.4 - Stalking (Section 354D IPC),2014,94,0,94
Total (UTs),4.5 - Others assault,2014,416,1,417
Total (UTs),5 - Insult to the Modesty of Women (Girls Children) (Section 509 IPC),2014,56,4,60
Total (UTs),"6 - Kidnapping & Abduction_Total (Section 363,364,364A, 366-369 IPC)",2014,550,8,558
Total (UTs),6.1 - Kidnapping & Abduction (Section 363 IPC),2014,494,8,502
Total (UTs),6.2 - Kidnaping & Abduction in order to Murder (Section 364 IPC),2014,0,0,0
Total (UTs),6.3 - Kidnapping for Ransom (Section 364A IPC),2014,14,0,14
Total (UTs),6.4 - Kidnapping & Abduction of Women to compel her for marriage (Section 366 IPC),2014,33,0,33
Total (UTs),6.5 - Other Kidnapping,2014,9,0,9
Total (UTs),7 - Foeticide (Section 315 and 316 IPC),2014,1,0,1
Total (UTs),8 - Abetment of Suicide of child (Section 305 IPC),2014,0,1,1
Total (UTs),9 - Exposure and Abandonment (Section 317 IPC),2014,1,1,2
Total (UTs),10 - Procuration of minor girls (Section 366-A IPC),2014,0,0,0
Total (UTs),11 - Importation of Girls from Foreign Country (Section 366-B IPC),2014,0,0,0
Total (UTs),12 - Buying of minors for prostitution (Section 373 IPC),2014,0,0,0
Total (UTs),13 - Selling of minors for prostitution (Section 372 IPC),2014,2,5,7
Total (UTs),"14 - Prohibition of Child Marriage Act, 2006",2014,7,4,11
Total (UTs),"15 - Transplantation of Human Organs Act, 1994",2014,0,0,0
Total (UTs),"16 - Child Labour (Prohibition & Regulation) Act, 1986",2014,34,1,35
Total (UTs),16.1 - Offences committed against Migrant,2014,8,0,8
Total (UTs),16.1.1 - Offences committed against SC migrants,2014,0,0,0
Total (UTs),16.1.2 - Offences committed against ST migrants,2014,0,0,0
Total (UTs),16.1.3 - Offences committed against others migrants,2014,8,0,8
Total (UTs),16.2 - Offences committed against Locals,2014,26,1,27
Total (UTs),16.2.1 - Offences committed against Local SCs,2014,0,0,0
Total (UTs),16.2.2 - Offences committed against Local STs,2014,0,0,0
Total (UTs),16.2.3 - Offences committed against others locals,2014,26,1,27
Total (UTs),"17 - Immoral Traffic (Prevention) Act, 1956",2014,1,3,4
Total (UTs),17.1 - Under ITP Section 5,2014,1,2,3
Total (UTs),17.2 - Under ITP Section 6,2014,0,0,0
Total (UTs),17.3 - Under ITP Section 7,2014,0,0,0
Total (UTs),17.4 - Under ITP Section 8,2014,0,0,0
Total (UTs),17.5 - Other Section of ITP Act,2014,0,1,1
Total (UTs),"18 - Juvenile Justice (Care and Protection of Children) Act, 2000",2014,107,8,115
Total (UTs),"19 - Protection of Children from Sexual Offences Act, 2012",2014,109,2,111
Total (UTs),19.1 - Under PCSO Act Section 4,2014,14,2,16
Total (UTs),19.2 - Under PCSO Act Section 6,2014,11,0,11
Total (UTs),19.3 - Under PCSO Act Section 8,2014,36,0,36
Total (UTs),19.4 - Under PCSO Act Section 10,2014,14,0,14
Total (UTs),19.5 - Under PCSO Act Sections 14 & 15,2014,0,0,0
Total (UTs),19.6 - Other Acts of PCSO,2014,34,0,34
Total (UTs),20 - Attempt to commit Murder u/s 307 IPC,2014,15,0,15
Total (UTs),21 - Unnatural Offences u/s 377 IPC,2014,131,0,131
Total (UTs),22 - Other crimes committed against children,2014,186,1,187
Total (UTs),23 - Total crimes against Children,2014,3102,49,3151
Total (All India),1 - Murder (Section 302 and 303 IPC),2014,2605,154,2759
Total (All India),2 - Infanticide (Section 315 IPC),2014,73,6,79
Total (All India),3 - Rape,2014,16149,226,16375
Total (All India),4 - Assault on women with intent to outrage her Modesty (Section 354 IPC),2014,13578,73,13651
Total (All India),4.1 - Sexual Harassment (Section 354A IPC),2014,5608,44,5652
Total (All India),4.2 - Assault on women with intent to Disrobe (Section 354B IPC),2014,922,1,923
Total (All India),4.3 - Voyeurism (Section 354C IPC),2014,120,0,120
Total (All India),4.4 - Stalking (Section 354D IPC),2014,1367,4,1371
Total (All India),4.5 - Others assault,2014,5561,24,5585
Total (All India),5 - Insult to the Modesty of Women (Girls Children) (Section 509 IPC),2014,530,4,534
Total (All India),"6 - Kidnapping & Abduction_Total (Section 363,364,364A, 366-369 IPC)",2014,28129,1023,29152
Total (All India),6.1 - Kidnapping & Abduction (Section 363 IPC),2014,8170,407,8577
Total (All India),6.2 - Kidnaping & Abduction in order to Murder (Section 364 IPC),2014,297,7,304
Total (All India),6.3 - Kidnapping for Ransom (Section 364A IPC),2014,361,8,369
Total (All India),6.4 - Kidnapping & Abduction of Women to compel her for marriage (Section 366 IPC),2014,14968,461,15429
Total (All India),6.5 - Other Kidnapping,2014,4333,140,4473
Total (All India),7 - Foeticide (Section 315 and 316 IPC),2014,42,6,48
Total (All India),8 - Abetment of Suicide of child (Section 305 IPC),2014,50,6,56
Total (All India),9 - Exposure and Abandonment (Section 317 IPC),2014,204,73,277
Total (All India),10 - Procuration of minor girls (Section 366-A IPC),2014,1948,19,1967
Total (All India),11 - Importation of Girls from Foreign Country (Section 366-B IPC),2014,4,2,6
Total (All India),12 - Buying of minors for prostitution (Section 373 IPC),2014,30,1,31
Total (All India),13 - Selling of minors for prostitution (Section 372 IPC),2014,94,15,109
Total (All India),"14 - Prohibition of Child Marriage Act, 2006",2014,571,147,718
Total (All India),"15 - Transplantation of Human Organs Act, 1994",2014,0,0,0
Total (All India),"16 - Child Labour (Prohibition & Regulation) Act, 1986",2014,153,3,156
Total (All India),16.1 - Offences committed against Migrant,2014,30,0,30
Total (All India),16.1.1 - Offences committed against SC migrants,2014,4,0,4
Total (All India),16.1.2 - Offences committed against ST migrants,2014,0,0,0
Total (All India),16.1.3 - Offences committed against others migrants,2014,26,0,26
Total (All India),16.2 - Offences committed against Locals,2014,123,3,126
Total (All India),16.2.1 - Offences committed against Local SCs,2014,2,0,2
Total (All India),16.2.2 - Offences committed against Local STs,2014,0,0,0
Total (All India),16.2.3 - Offences committed against others locals,2014,121,3,124
Total (All India),"17 - Immoral Traffic (Prevention) Act, 1956",2014,138,71,209
Total (All India),17.1 - Under ITP Section 5,2014,28,19,47
Total (All India),17.2 - Under ITP Section 6,2014,4,3,7
Total (All India),17.3 - Under ITP Section 7,2014,17,5,22
Total (All India),17.4 - Under ITP Section 8,2014,3,1,4
Total (All India),17.5 - Other Section of ITP Act,2014,86,43,129
Total (All India),"18 - Juvenile Justice (Care and Protection of Children) Act, 2000",2014,1357,132,1489
Total (All India),"19 - Protection of Children from Sexual Offences Act, 2012",2014,11026,146,11172
Total (All India),19.1 - Under PCSO Act Section 4,2014,5097,72,5169
Total (All India),19.2 - Under PCSO Act Section 6,2014,905,10,915
Total (All India),19.3 - Under PCSO Act Section 8,2014,2975,17,2992
Total (All India),19.4 - Under PCSO Act Section 10,2014,200,31,231
Total (All India),19.5 - Under PCSO Act Sections 14 & 15,2014,47,0,47
Total (All India),19.6 - Other Acts of PCSO,2014,1802,16,1818
Total (All India),20 - Attempt to commit Murder u/s 307 IPC,2014,2398,104,2502
Total (All India),21 - Unnatural Offences u/s 377 IPC,2014,864,4,868
Total (All India),22 - Other crimes committed against children,2014,10881,421,11302
Total (All India),23 - Total crimes against Children,2014,90824,2636,93460
